Rk,Tkl-Tack,TklW-Tack,Def3rd-Tack,Mid3rd-Tack,Att3rd-Tack,Tkl-Chal,Att-Chal,Tkl%-Chal,Lost-Chal,Blocks-Bloc,Sh-Tack-Bloc,Pass-Tack-Bloc,Int,Tkl+Int,Clr,Err
1,64,44,49,15,0,37,55,67.3,18,39,19,20,28,92,96,1
2,48,27,34,14,0,16,32,50,16,50,25,25,68,116,104,0
3,43,23,25,16,2,20,57,35.1,37,18,1,17,42,85,15,0
4,110,60,44,53,13,71,166,42.8,95,58,1,57,55,165,13,0
5,0,0,0,0,0,0,1,0,1,2,0,2,0,0,0,0
6,11,7,4,5,2,2,10,20,8,12,1,11,4,15,8,0
7,0,0,0,0,0,0,0,,0,2,0,2,0,0,1,0
8,27,13,7,14,6,9,22,40.9,13,17,3,14,5,32,27,0
9,6,3,3,3,0,2,4,50,2,6,5,1,5,11,37,1
10,25,12,15,9,1,12,19,63.2,7,37,28,9,34,59,92,0
11,2,0,0,1,1,1,4,25,3,3,0,3,0,2,1,0
12,0,0,0,0,0,0,0,,0,0,0,0,0,0,0,0
13,50,29,27,14,9,30,46,65.2,16,22,5,17,14,64,25,1
14,13,6,5,5,3,2,16,12.5,14,18,2,16,8,21,18,0
15,23,7,5,16,2,7,25,28,18,24,1,23,16,39,19,2
16,8,6,3,4,1,3,11,27.3,8,4,0,4,1,9,2,0
17,15,11,5,8,2,8,16,50,8,0,0,0,11,26,6,0
18,27,14,10,14,3,8,15,53.3,7,26,2,24,11,38,12,0
19,43,27,22,14,7,19,68,27.9,49,33,3,30,37,80,11,2
20,14,5,5,8,1,6,11,54.5,5,4,1,3,6,20,3,0
21,10,3,1,6,3,4,7,57.1,3,4,0,4,3,13,0,0
22,34,22,17,11,6,18,37,48.6,19,20,3,17,25,59,38,0
23,0,0,0,0,0,0,0,,0,0,0,0,0,0,2,0
24,51,31,24,20,7,23,45,51.1,22,30,9,21,52,103,27,1
25,44,26,13,26,5,7,20,35,13,22,0,22,8,52,6,0
26,27,18,16,11,0,14,24,58.3,10,24,14,10,24,51,127,1
27,1,1,0,0,1,0,2,0,2,0,0,0,0,1,0,0
28,78,53,39,32,7,43,68,63.2,25,19,4,15,44,122,57,0
29,0,0,0,0,0,0,0,,0,0,0,0,0,0,0,0
30,1,0,1,0,0,1,3,33.3,2,0,0,0,0,1,0,0
31,38,26,27,9,2,20,31,64.5,11,16,8,8,22,60,44,0
32,16,9,4,9,3,5,19,26.3,14,8,1,7,19,35,7,0
33,39,26,28,10,1,17,31,54.8,14,23,13,10,38,77,96,3
34,27,19,11,10,6,15,23,65.2,8,17,3,14,28,55,30,0
35,64,36,46,15,3,22,44,50,22,24,2,22,22,86,39,1
36,29,18,21,6,2,13,21,61.9,8,19,11,8,26,55,74,0
37,36,25,5,19,12,7,40,17.5,33,28,3,25,8,44,31,1
38,33,23,20,11,2,22,32,68.8,10,26,15,11,35,68,58,0
39,43,31,26,15,2,21,37,56.8,16,26,7,19,51,94,61,0
40,0,0,0,0,0,0,2,0,2,0,0,0,1,1,0,0
41,16,9,7,8,1,6,8,75,2,7,5,2,8,24,23,0
42,2,0,0,1,1,0,0,,0,0,0,0,0,2,0,0
43,2,0,0,2,0,0,1,0,1,2,0,2,0,2,0,0
44,14,9,5,7,2,8,12,66.7,4,6,0,6,11,25,6,0
45,17,10,7,9,1,7,12,58.3,5,4,2,2,2,19,6,0
46,33,19,16,11,6,16,28,57.1,12,32,2,30,20,53,29,2
47,23,13,15,6,2,9,19,47.4,10,26,15,11,22,45,70,1
48,7,4,3,4,0,2,5,40,3,4,0,4,1,8,4,0
49,31,20,17,10,4,10,31,32.3,21,19,7,12,30,61,31,0
50,6,5,0,2,4,2,5,40,3,5,0,5,1,7,6,0
51,47,34,12,26,9,27,47,57.4,20,26,6,20,33,80,41,1
52,0,0,0,0,0,0,0,,0,0,0,0,1,1,2,0
53,29,17,8,11,10,8,52,15.4,44,32,4,28,13,42,7,0
54,26,15,20,5,1,14,18,77.8,4,24,15,9,21,47,126,1
55,31,19,16,9,6,10,47,21.3,37,15,3,12,14,45,20,0
56,9,3,2,4,3,1,5,20,4,7,0,7,6,15,1,0
57,48,29,14,24,10,10,42,23.8,32,22,2,20,26,74,13,2
58,41,20,14,24,3,22,45,48.9,23,10,2,8,13,54,14,0
59,53,34,34,17,2,34,53,64.2,19,30,18,12,35,88,153,0
60,33,15,21,10,2,15,44,34.1,29,12,0,12,8,41,17,0
61,0,0,0,0,0,0,0,,0,0,0,0,0,0,9,1
62,27,19,11,13,3,9,48,18.8,39,21,2,19,15,42,16,0
63,40,23,19,13,8,27,60,45,33,22,4,18,43,83,40,0
64,10,5,1,4,5,5,17,29.4,12,17,1,16,8,18,0,1
65,3,1,3,0,0,3,5,60,2,1,0,1,0,3,28,1
66,74,44,28,39,7,34,105,32.4,71,40,9,31,23,97,39,1
67,18,13,8,8,2,5,18,27.8,13,11,0,11,6,24,4,0
68,14,8,10,3,1,5,17,29.4,12,22,5,17,6,20,16,0
69,7,2,3,4,0,0,4,0,4,7,2,5,6,13,10,0
70,47,29,23,17,7,11,44,25,33,14,1,13,20,67,13,0
71,41,29,20,12,9,17,36,47.2,19,29,5,24,43,84,53,0
72,39,28,18,18,3,21,26,80.8,5,17,5,12,30,69,70,0
73,1,0,1,0,0,0,0,,0,0,0,0,0,1,1,0
74,24,14,15,8,1,10,18,55.6,8,21,16,5,45,69,97,0
75,30,19,13,13,4,14,26,53.8,12,10,3,7,11,41,10,2
76,10,4,4,5,1,4,7,57.1,3,2,1,1,10,20,10,0
77,16,8,10,6,0,8,15,53.3,7,4,2,2,14,30,26,0
78,0,0,0,0,0,0,2,0,2,1,0,1,0,0,0,0
79,26,13,19,7,0,19,29,65.5,10,30,22,8,21,47,93,4
80,21,11,11,6,4,7,17,41.2,10,12,0,12,7,28,7,0
81,16,10,8,7,1,10,17,58.8,7,3,1,2,15,31,7,0
82,6,5,3,1,2,5,10,50,5,1,0,1,1,7,3,0
83,3,2,1,1,1,2,3,66.7,1,2,0,2,3,6,1,0
84,66,42,43,18,5,30,41,73.2,11,39,21,18,32,98,75,0
85,6,4,2,2,2,2,9,22.2,7,7,0,7,0,6,0,0
86,8,4,3,2,3,4,8,50,4,4,2,2,5,13,0,0
87,67,43,37,27,3,24,58,41.4,34,49,19,30,51,118,76,0
88,24,13,9,13,2,11,19,57.9,8,25,8,17,5,29,6,1
89,30,23,21,9,0,16,27,59.3,11,29,19,10,37,67,125,3
90,71,45,30,33,8,27,99,27.3,72,65,6,59,20,91,16,0
91,11,7,0,3,8,3,9,33.3,6,8,0,8,3,14,14,0
92,1,1,1,0,0,0,1,0,1,2,0,2,0,1,1,0
93,27,16,18,8,1,17,35,48.6,18,16,7,9,19,46,44,0
94,123,69,49,65,9,51,113,45.1,62,49,11,38,50,173,56,0
95,12,10,7,4,1,7,9,77.8,2,6,2,4,6,18,8,0
96,33,17,18,14,1,14,28,50,14,19,7,12,31,64,46,0
97,20,13,9,9,2,9,14,64.3,5,6,1,5,10,30,21,0
98,28,21,14,13,1,14,30,46.7,16,24,3,21,29,57,40,0
99,1,1,1,0,0,0,0,,0,0,0,0,1,2,1,0
100,20,9,11,7,2,10,13,76.9,3,9,1,8,6,26,10,0
101,18,11,6,6,6,5,13,38.5,8,7,1,6,4,22,6,0
102,40,26,22,15,3,19,32,59.4,13,27,16,11,32,72,116,1
103,0,0,0,0,0,0,0,,0,1,0,1,1,1,3,1
104,23,17,5,9,9,7,18,38.9,11,19,1,18,3,26,13,0
105,21,18,7,8,6,6,26,23.1,20,12,0,12,1,22,8,0
106,46,30,9,25,12,27,54,50,27,26,1,25,20,66,5,0
107,13,6,5,5,3,5,33,15.2,28,18,1,17,17,30,4,0
108,55,34,35,18,2,28,48,58.3,20,30,13,17,27,82,74,0
109,62,37,19,32,11,20,68,29.4,48,35,5,30,32,94,18,0
110,20,15,5,9,6,8,33,24.2,25,20,2,18,8,28,19,0
111,45,25,18,21,6,22,52,42.3,30,24,4,20,33,78,21,0
112,22,14,17,5,0,9,21,42.9,12,17,10,7,27,49,105,2
113,41,23,29,12,0,21,25,84,4,37,20,17,23,64,66,1
114,0,0,0,0,0,0,0,,0,0,0,0,0,0,0,0
115,0,0,0,0,0,0,0,,0,0,0,0,0,0,1,0
116,3,3,2,1,0,0,2,0,2,0,0,0,0,3,2,1
117,5,3,2,1,2,4,9,44.4,5,1,0,1,1,6,1,0
118,12,5,8,3,1,4,9,44.4,5,8,4,4,5,17,10,0
119,10,4,2,2,6,0,6,0,6,13,1,12,3,13,6,0
120,27,19,15,6,6,9,23,39.1,14,10,1,9,8,35,15,0
121,17,9,1,11,5,7,30,23.3,23,13,2,11,7,24,17,0
122,37,20,19,16,2,20,50,40,30,43,15,28,37,74,55,0
123,0,0,0,0,0,0,0,,0,0,0,0,0,0,4,0
124,35,20,15,16,4,19,50,38,31,17,4,13,13,48,23,1
125,9,5,2,5,2,4,7,57.1,3,4,1,3,1,10,8,0
126,14,6,6,5,3,6,13,46.2,7,6,0,6,4,18,7,0
127,11,6,3,6,2,5,19,26.3,14,14,1,13,7,18,7,0
128,93,54,50,37,6,38,89,42.7,51,31,6,25,41,134,42,0
129,0,0,0,0,0,0,1,0,1,0,0,0,1,1,6,0
130,0,0,0,0,0,0,0,,0,0,0,0,0,0,0,0
131,12,8,6,4,2,4,18,22.2,14,8,1,7,12,24,6,1
132,0,0,0,0,0,0,0,,0,1,0,1,1,1,1,0
133,18,6,7,11,0,9,19,47.4,10,14,7,7,15,33,15,0
134,0,0,0,0,0,0,1,0,1,0,0,0,0,0,0,0
135,18,9,9,8,1,11,29,37.9,18,16,7,9,19,37,15,1
136,14,7,1,5,8,4,24,16.7,20,23,2,21,11,25,19,0
137,15,10,11,3,1,5,9,55.6,4,3,1,2,11,26,19,0
138,13,6,4,5,4,4,8,50,4,14,2,12,8,21,16,0
139,29,19,17,10,2,14,25,56,11,13,2,11,32,61,21,0
140,11,5,6,4,1,3,10,30,7,12,1,11,0,11,4,0
141,2,2,0,1,1,0,5,0,5,9,1,8,2,4,4,0
142,3,1,3,0,0,3,5,60,2,0,0,0,2,5,17,2
143,36,20,22,8,6,17,29,58.6,12,19,4,15,29,65,68,1
144,1,0,0,0,1,0,3,0,3,1,0,1,0,1,0,0
145,18,14,11,3,4,8,13,61.5,5,10,3,7,5,23,21,0
146,14,9,11,2,1,4,7,57.1,3,14,7,7,11,25,25,0
147,17,7,6,7,4,7,21,33.3,14,14,2,12,13,30,15,1
148,11,7,3,6,2,1,9,11.1,8,11,2,9,2,13,29,0
149,1,1,1,0,0,1,1,100,0,0,0,0,0,1,4,0
150,47,30,20,20,7,17,31,54.8,14,33,3,30,15,62,15,0
151,20,12,14,6,0,7,15,46.7,8,20,14,6,13,33,57,0
152,74,42,46,23,5,51,97,52.6,46,46,25,21,28,102,52,1
153,6,5,4,2,0,3,5,60,2,4,2,2,1,7,10,0
154,3,1,0,2,1,0,5,0,5,2,0,2,0,3,8,0
155,51,28,18,27,6,16,35,45.7,19,32,9,23,23,74,65,1
156,57,30,31,23,3,25,43,58.1,18,19,5,14,24,81,34,1
157,4,4,2,0,2,0,3,0,3,5,0,5,1,5,5,0
158,0,0,0,0,0,0,0,,0,0,0,0,1,1,5,0
159,6,5,4,2,0,3,5,60,2,12,10,2,12,18,48,0
160,64,37,25,30,9,34,80,42.5,46,39,7,32,85,149,43,0
161,0,0,0,0,0,0,0,,0,0,0,0,0,0,16,2
162,36,19,21,15,0,14,23,60.9,9,18,12,6,28,64,68,1
163,1,0,0,1,0,0,1,0,1,0,0,0,0,1,0,0
164,0,0,0,0,0,0,0,,0,0,0,0,0,0,0,0
165,0,0,0,0,0,0,0,,0,0,0,0,0,0,0,0
166,0,0,0,0,0,0,0,,0,0,0,0,0,0,0,0
167,13,8,2,7,4,1,9,11.1,8,15,0,15,3,16,3,0
168,17,11,6,8,3,6,13,46.2,7,10,1,9,1,18,2,0
169,5,4,4,0,1,3,4,75,1,4,2,2,3,8,11,0
170,3,3,1,2,0,1,1,100,0,3,1,2,3,6,5,0
171,0,0,0,0,0,0,0,,0,0,0,0,0,0,4,0
172,21,14,5,13,3,4,14,28.6,10,11,0,11,3,24,8,0
173,2,0,1,0,1,0,3,0,3,2,0,2,0,2,1,0
174,15,9,13,2,0,8,12,66.7,4,5,4,1,12,27,15,0
175,19,13,9,7,3,5,16,31.3,11,8,1,7,9,28,10,2
176,33,22,16,12,5,20,34,58.8,14,13,2,11,23,56,42,3
177,62,37,30,24,8,25,65,38.5,40,43,1,42,21,83,52,1
178,1,1,0,1,0,1,2,50,1,0,0,0,0,1,1,0
179,0,0,0,0,0,0,0,,0,1,0,1,0,0,0,0
180,2,1,1,0,1,0,0,,0,2,2,0,1,3,1,0
181,0,0,0,0,0,0,0,,0,0,0,0,0,0,0,0
182,8,4,1,5,2,1,10,10,9,6,0,6,4,12,6,0
183,2,1,1,0,1,1,4,25,3,2,0,2,2,4,1,0
184,33,24,15,15,3,25,43,58.1,18,27,4,23,21,54,79,0
185,9,6,9,0,0,5,14,35.7,9,11,4,7,19,28,30,0
186,45,22,25,11,9,19,31,61.3,12,24,5,19,39,84,64,0
187,18,14,5,13,0,4,9,44.4,5,6,2,4,3,21,5,0
188,1,1,0,0,1,0,0,,0,1,0,1,0,1,1,0
189,6,5,6,0,0,4,11,36.4,7,5,1,4,9,15,13,0
190,30,12,13,9,8,13,36,36.1,23,24,1,23,21,51,10,0
191,1,0,0,1,0,0,3,0,3,8,2,6,2,3,8,0
192,33,20,10,17,6,15,31,48.4,16,22,5,17,10,43,37,2
193,23,13,17,6,0,14,18,77.8,4,19,11,8,20,43,76,0
194,2,1,0,0,2,0,2,0,2,1,0,1,1,3,2,0
195,14,4,9,4,1,6,15,40,9,10,0,10,11,25,12,0
196,18,8,9,8,1,5,17,29.4,12,32,5,27,6,24,26,0
197,0,0,0,0,0,0,0,,0,0,0,0,0,0,1,0
198,0,0,0,0,0,0,0,,0,1,1,0,2,2,10,0
199,0,0,0,0,0,0,0,,0,1,1,0,1,1,0,1
200,7,4,2,3,2,1,8,12.5,7,7,1,6,2,9,1,0
201,59,37,38,17,4,41,63,65.1,22,33,10,23,51,110,56,0
202,29,12,12,14,3,12,35,34.3,23,13,2,11,10,39,7,0
203,0,0,0,0,0,0,0,,0,0,0,0,0,0,0,0
204,27,17,14,12,1,11,31,35.5,20,20,10,10,15,42,26,1
205,63,42,17,35,11,29,55,52.7,26,26,2,24,21,84,8,2
206,15,11,4,7,4,8,22,36.4,14,10,1,9,9,24,4,0
207,0,0,0,0,0,0,1,0,1,1,0,1,1,1,0,0
208,6,2,2,3,1,2,7,28.6,5,4,1,3,5,11,6,0
209,11,2,2,7,2,2,9,22.2,7,8,1,7,2,13,5,0
210,31,16,9,11,11,7,23,30.4,16,24,1,23,5,36,7,0
211,21,14,13,7,1,11,17,64.7,6,5,3,2,17,38,34,0
212,63,32,23,27,13,29,50,58,21,23,6,17,32,95,23,0
213,15,10,9,6,0,8,18,44.4,10,7,0,7,2,17,2,0
214,16,12,10,6,0,8,21,38.1,13,19,7,12,28,44,43,0
215,12,4,4,4,4,6,20,30,14,20,1,19,6,18,8,0
216,6,4,3,3,0,5,7,71.4,2,5,2,3,4,10,1,0
217,39,14,18,17,4,19,35,54.3,16,39,22,17,33,72,105,1
218,3,3,2,0,1,2,6,33.3,4,0,0,0,1,4,2,0
219,6,5,3,1,2,1,5,20,4,2,0,2,2,8,5,0
220,12,8,3,9,0,5,17,29.4,12,13,4,9,4,16,21,0
221,2,2,1,0,1,0,4,0,4,4,1,3,2,4,0,0
222,6,3,2,3,1,1,3,33.3,2,5,0,5,0,6,0,0
223,7,4,2,4,1,4,5,80,1,1,0,1,3,10,1,0
224,44,25,28,13,3,17,34,50,17,22,12,10,35,79,59,1
225,52,34,28,17,7,21,65,32.3,44,38,11,27,30,82,31,0
226,1,0,0,0,1,0,8,0,8,1,0,1,1,2,1,0
227,32,16,13,19,0,15,30,50,15,21,10,11,10,42,36,0
228,28,15,17,10,1,11,28,39.3,17,24,14,10,29,57,99,0
229,0,0,0,0,0,0,3,0,3,0,0,0,0,0,19,1
230,59,28,34,21,4,31,47,66,16,27,11,16,37,96,58,0
231,3,1,2,1,0,1,2,50,1,1,0,1,2,5,0,0
232,28,15,14,7,7,13,32,40.6,19,24,3,21,8,36,16,0
233,3,0,0,3,0,0,1,0,1,1,0,1,1,4,1,0
234,1,1,0,1,0,0,0,,0,0,0,0,0,1,1,0
235,5,2,2,2,1,3,4,75,1,8,2,6,1,6,4,0
236,6,5,1,3,2,4,16,25,12,18,0,18,3,9,6,0
237,22,14,5,12,5,7,21,33.3,14,20,3,17,12,34,25,0
238,81,46,49,30,2,34,60,56.7,26,45,20,25,42,123,89,3
239,8,7,6,2,0,6,7,85.7,1,9,6,3,6,14,25,0
240,9,6,3,4,2,6,18,33.3,12,11,0,11,2,11,4,0
241,32,15,18,13,1,19,33,57.6,14,48,27,21,72,104,141,0
242,6,4,4,1,1,1,2,50,1,5,1,4,2,8,1,0
243,15,7,8,6,1,6,13,46.2,7,6,2,4,6,21,4,0
244,0,0,0,0,0,0,0,,0,0,0,0,0,0,3,0
245,3,1,0,2,1,0,7,0,7,4,1,3,1,4,4,0
246,3,2,1,1,1,0,4,0,4,3,0,3,3,6,7,0
247,2,1,0,0,2,2,9,22.2,7,5,1,4,7,9,4,0
248,0,0,0,0,0,0,0,,0,0,0,0,0,0,9,1
249,9,6,4,4,1,4,8,50,4,9,1,8,5,14,16,0
250,46,23,21,21,4,18,39,46.2,21,26,6,20,48,94,30,1
251,54,23,37,16,1,30,63,47.6,33,26,15,11,41,95,112,1
252,34,20,25,9,0,18,28,64.3,10,21,16,5,42,76,84,2
253,29,15,14,12,3,6,27,22.2,21,39,8,31,21,50,51,0
254,9,4,4,4,1,3,13,23.1,10,5,0,5,9,18,4,0
255,51,32,21,21,9,17,41,41.5,24,29,4,25,27,78,19,0
256,52,32,29,20,3,31,44,70.5,13,11,2,9,23,75,57,1
257,52,34,15,31,6,21,53,39.6,32,50,4,46,42,94,32,0
258,7,7,7,0,0,4,4,100,0,5,4,1,6,13,11,0
259,0,0,0,0,0,0,0,,0,0,0,0,0,0,0,0
260,7,3,2,2,3,3,12,25,9,12,4,8,2,9,9,0
261,56,41,27,23,6,28,68,41.2,40,29,5,24,32,88,39,0
262,4,2,2,1,1,2,4,50,2,3,0,3,0,4,1,0
263,0,0,0,0,0,0,0,,0,0,0,0,0,0,0,0
264,18,8,1,11,6,6,15,40,9,12,1,11,0,18,1,0
265,1,0,1,0,0,1,2,50,1,3,0,3,3,4,3,0
266,6,3,3,2,1,1,10,10,9,4,0,4,3,9,6,0
267,5,1,2,2,1,3,6,50,3,4,0,4,1,6,1,0
268,0,0,0,0,0,0,0,,0,2,0,2,0,0,0,0
269,5,3,1,3,1,1,6,16.7,5,5,2,3,2,7,5,0
270,0,0,0,0,0,0,2,0,2,1,0,1,0,0,12,2
271,2,1,1,0,1,0,1,0,1,2,0,2,0,2,2,0
272,0,0,0,0,0,0,0,,0,0,0,0,1,1,3,1
273,0,0,0,0,0,0,1,0,1,0,0,0,0,0,0,0
274,0,0,0,0,0,0,0,,0,0,0,0,0,0,0,0
275,44,30,22,15,7,21,50,42,29,20,4,16,25,69,15,0
276,2,0,1,1,0,1,1,100,0,1,0,1,0,2,0,0
277,28,17,16,9,3,15,38,39.5,23,17,1,16,9,37,8,0
278,42,30,24,15,3,27,44,61.4,17,33,7,26,39,81,77,1
279,42,24,15,20,7,16,29,55.2,13,24,9,15,28,70,13,0
280,36,18,14,14,8,16,32,50,16,24,9,15,20,56,35,0
281,32,18,11,18,3,7,20,35,13,15,2,13,26,58,15,1
282,3,2,1,2,0,2,6,33.3,4,7,3,4,2,5,33,0
283,11,9,5,3,3,2,9,22.2,7,10,0,10,4,15,13,0
284,0,0,0,0,0,0,0,,0,0,0,0,0,0,0,0
285,32,19,9,16,7,15,57,26.3,42,39,2,37,31,63,23,0
286,25,11,10,11,4,7,14,50,7,19,6,13,13,38,25,0
287,45,26,23,14,8,11,51,21.6,40,40,2,38,16,61,20,0
288,64,38,34,25,5,37,80,46.3,43,38,12,26,42,106,73,1
289,16,6,7,7,2,5,20,25,15,11,2,9,12,28,22,0
290,14,6,6,8,0,0,4,0,4,2,1,1,4,18,3,0
291,8,5,7,0,1,6,15,40,9,9,0,9,4,12,7,0
292,3,2,2,1,0,1,10,10,9,3,0,3,1,4,8,0
293,0,0,0,0,0,0,0,,0,0,0,0,0,0,4,0
294,10,7,2,5,3,2,10,20,8,9,0,9,4,14,3,0
295,16,10,7,4,5,6,13,46.2,7,12,4,8,5,21,15,0
296,3,2,3,0,0,3,4,75,1,0,0,0,0,3,8,1
297,0,0,0,0,0,0,0,,0,0,0,0,0,0,14,2
298,24,14,10,10,4,13,18,72.2,5,8,0,8,8,32,16,0
299,0,0,0,0,0,0,1,0,1,0,0,0,0,0,5,1
300,29,14,5,17,7,12,34,35.3,22,14,2,12,8,37,4,1
301,3,2,3,0,0,3,4,75,1,0,0,0,3,6,1,0
302,8,5,3,4,1,2,5,40,3,8,3,5,1,9,7,0
303,7,2,3,3,1,4,15,26.7,11,13,3,10,5,12,11,0
304,21,6,2,14,5,9,19,47.4,10,16,1,15,5,26,25,1
305,46,27,32,13,1,23,39,59,16,18,5,13,15,61,52,2
306,0,0,0,0,0,0,1,0,1,1,0,1,0,0,2,0
307,70,42,44,22,4,40,69,58,29,23,8,15,53,123,71,1
308,0,0,0,0,0,0,0,,0,0,0,0,0,0,0,0
309,1,0,0,1,0,0,3,0,3,0,0,0,1,2,2,0
310,24,10,16,8,0,9,20,45,11,21,16,5,18,42,77,1
311,13,6,4,6,3,2,7,28.6,5,10,3,7,6,19,19,0
312,17,8,14,1,2,8,11,72.7,3,9,1,8,10,27,35,0
313,8,4,7,1,0,4,6,66.7,2,6,5,1,17,25,33,1
314,37,24,17,15,5,22,53,41.5,31,28,10,18,19,56,31,1
315,31,16,19,9,3,17,24,70.8,7,16,9,7,16,47,26,0
316,0,0,0,0,0,0,0,,0,1,0,1,0,0,1,0
317,76,49,35,37,4,21,37,56.8,16,33,3,30,50,126,49,0
318,0,0,0,0,0,0,0,,0,1,0,1,0,0,0,0
319,3,1,3,0,0,3,5,60,2,1,0,1,0,3,24,1
320,0,0,0,0,0,0,0,,0,0,0,0,0,0,0,0
321,2,0,1,1,0,0,0,,0,1,1,0,1,3,0,0
322,33,18,7,20,6,15,44,34.1,29,33,3,30,31,64,6,1
323,2,1,0,0,2,0,2,0,2,4,0,4,2,4,1,0
324,9,7,2,3,4,1,5,20,4,6,0,6,2,11,1,0
325,20,15,11,9,0,9,17,52.9,8,20,10,10,20,40,73,0
326,6,5,1,4,1,3,9,33.3,6,7,2,5,6,12,11,0
327,1,0,0,1,0,0,0,,0,0,0,0,1,2,0,0
328,20,14,13,4,3,12,20,60,8,10,1,9,14,34,18,0
329,40,23,18,17,5,22,53,41.5,31,41,3,38,25,65,11,0
330,7,3,0,4,3,4,6,66.7,2,6,0,6,1,8,3,1
331,7,4,1,2,4,2,3,66.7,1,3,0,3,2,9,1,1
332,6,3,6,0,0,4,8,50,4,3,2,1,6,12,21,0
333,15,9,4,9,2,10,20,50,10,17,3,14,12,27,14,0
334,19,11,6,10,3,8,17,47.1,9,15,0,15,6,25,5,0
335,2,1,0,2,0,0,0,,0,0,0,0,0,2,0,0
336,25,19,18,7,0,8,15,53.3,7,14,6,8,14,39,35,0
337,33,17,12,16,5,21,46,45.7,25,20,2,18,14,47,9,1
338,24,12,9,8,7,6,25,24,19,17,1,16,6,30,7,0
339,0,0,0,0,0,0,0,,0,0,0,0,0,0,0,0
340,25,16,16,7,2,13,14,92.9,1,22,7,15,16,41,35,0
341,0,0,0,0,0,0,0,,0,1,0,1,1,1,0,0
342,14,5,4,10,0,8,13,61.5,5,22,17,5,26,40,82,0
343,30,19,23,5,2,16,25,64,9,29,8,21,42,72,97,1
344,31,22,4,13,14,7,33,21.2,26,24,4,20,5,36,9,0
345,24,11,13,11,0,12,18,66.7,6,32,21,11,26,50,116,0
346,46,25,14,13,19,22,63,34.9,41,30,0,30,8,54,34,1
347,31,18,15,10,6,13,36,36.1,23,17,4,13,18,49,15,0
348,27,15,11,12,4,12,29,41.4,17,17,2,15,10,37,5,0
349,44,29,19,16,9,18,38,47.4,20,19,2,17,7,51,1,0
350,18,10,7,9,2,14,38,36.8,24,8,2,6,12,30,5,0
351,0,0,0,0,0,0,0,,0,0,0,0,0,0,11,1
352,2,2,1,1,0,0,0,,0,1,1,0,2,4,5,0
353,5,1,2,3,0,3,11,27.3,8,7,6,1,3,8,10,0
354,46,24,16,18,12,24,67,35.8,43,33,3,30,30,76,44,0
355,0,0,0,0,0,0,0,,0,0,0,0,0,0,0,0
356,1,1,1,0,0,0,2,0,2,1,0,1,1,2,0,0
357,36,20,20,11,5,17,44,38.6,27,29,2,27,21,57,14,0
358,15,13,11,3,1,8,11,72.7,3,17,13,4,17,32,134,1
359,27,13,5,15,7,9,24,37.5,15,24,1,23,2,29,23,0
360,11,9,8,2,1,7,12,58.3,5,5,2,3,10,21,7,1
361,1,1,0,1,0,0,2,0,2,1,0,1,2,3,1,0
362,1,1,0,1,0,0,3,0,3,0,0,0,1,2,1,0
363,1,1,0,0,1,0,0,,0,2,0,2,1,2,1,0
364,37,19,13,20,4,17,54,31.5,37,19,2,17,24,61,14,1
365,4,1,3,1,0,3,8,37.5,5,3,2,1,1,5,20,0
366,35,22,19,14,2,14,40,35,26,25,8,17,25,60,15,0
367,40,24,23,13,4,10,21,47.6,11,31,21,10,32,72,86,0
368,0,0,0,0,0,0,0,,0,0,0,0,0,0,6,2
369,1,1,0,1,0,0,0,,0,0,0,0,0,1,0,0
370,0,0,0,0,0,0,0,,0,0,0,0,0,0,1,0
371,9,5,5,1,3,3,21,14.3,18,16,1,15,4,13,7,1
372,0,0,0,0,0,0,0,,0,0,0,0,0,0,0,0
373,49,24,27,22,0,18,28,64.3,10,54,23,31,105,154,137,0
374,2,0,2,0,0,0,2,0,2,0,0,0,1,3,2,0
375,6,3,3,2,1,3,7,42.9,4,7,3,4,4,10,6,1
376,1,0,0,1,0,1,1,100,0,1,0,1,0,1,0,0
377,12,5,2,7,3,2,9,22.2,7,17,1,16,3,15,11,0
378,47,29,33,13,1,20,31,64.5,11,32,19,13,40,87,78,1
379,47,25,25,18,4,36,60,60,24,33,19,14,41,88,125,1
380,2,1,1,1,0,1,1,100,0,6,0,6,3,5,9,0
381,73,37,25,42,6,21,53,39.6,32,37,12,25,68,141,42,1
382,77,45,34,35,8,34,68,50,34,28,10,18,37,114,36,2
383,51,35,29,20,2,25,49,51,24,27,10,17,43,94,84,0
384,0,0,0,0,0,0,0,,0,1,0,1,0,0,0,0
385,2,1,1,1,0,0,5,0,5,14,3,11,5,7,5,2
386,3,0,1,0,2,1,2,50,1,2,0,2,0,3,0,0
387,13,8,6,3,4,2,13,15.4,11,13,0,13,1,14,4,0
388,24,10,3,15,6,6,19,31.6,13,22,4,18,3,27,16,0
389,38,18,16,13,9,21,51,41.2,30,21,3,18,9,47,11,0
390,18,8,7,6,5,8,22,36.4,14,8,0,8,8,26,1,0
391,0,0,0,0,0,0,1,0,1,0,0,0,0,0,1,0
392,20,9,9,8,3,9,13,69.2,4,12,6,6,31,51,44,0
393,1,1,1,0,0,1,2,50,1,0,0,0,0,1,11,1
394,1,1,1,0,0,0,1,0,1,0,0,0,0,1,0,0
395,17,8,0,10,7,6,25,24,19,31,5,26,8,25,16,0
396,0,0,0,0,0,0,0,,0,0,0,0,0,0,0,0
397,16,11,11,4,1,7,11,63.6,4,22,14,8,20,36,101,0
398,22,12,13,8,1,6,15,40,9,14,10,4,24,46,51,0
399,26,15,20,5,1,19,36,52.8,17,19,5,14,17,43,28,0
400,53,28,27,20,6,28,63,44.4,35,45,13,32,21,74,30,1
401,3,3,0,3,0,2,6,33.3,4,7,4,3,1,4,2,0
402,93,49,31,48,14,46,83,55.4,37,44,8,36,45,138,31,0
403,0,0,0,0,0,0,0,,0,0,0,0,0,0,1,0
404,0,0,0,0,0,0,0,,0,0,0,0,0,0,0,0
405,0,0,0,0,0,0,0,,0,0,0,0,0,0,0,0
406,3,2,0,2,1,2,5,40,3,4,1,3,1,4,1,0
407,24,15,17,6,1,19,27,70.4,8,21,11,10,22,46,48,0
408,2,1,1,1,0,2,5,40,3,5,2,3,4,6,10,0
409,0,0,0,0,0,0,0,,0,0,0,0,0,0,2,1
410,15,7,4,8,3,5,15,33.3,10,7,0,7,5,20,1,0
411,81,44,59,15,7,47,83,56.6,36,29,0,29,32,113,30,0
412,2,1,1,0,1,0,0,,0,1,1,0,1,3,1,0
413,37,24,27,10,0,21,34,61.8,13,32,23,9,44,81,222,2
414,15,6,8,4,3,8,8,100,0,7,2,5,8,23,9,0
415,13,7,5,5,3,4,12,33.3,8,12,3,9,14,27,21,0
416,2,2,2,0,0,1,5,20,4,2,2,0,11,13,16,1
417,65,34,35,24,6,33,55,60,22,22,3,19,33,98,49,1
418,4,2,3,1,0,0,7,0,7,2,0,2,3,7,1,0
419,5,2,2,3,0,0,5,0,5,8,2,6,9,14,12,0
420,3,3,0,2,1,0,1,0,1,1,0,1,0,3,4,0
421,0,0,0,0,0,0,0,,0,1,0,1,0,0,0,0
422,16,10,7,7,2,5,12,41.7,7,18,4,14,10,26,7,0
423,0,0,0,0,0,0,2,0,2,0,0,0,2,2,9,1
424,10,6,6,2,2,6,17,35.3,11,7,2,5,5,15,6,0
425,9,4,9,0,0,8,17,47.1,9,12,6,6,12,21,56,0
426,62,37,31,23,8,37,72,51.4,35,25,5,20,23,85,40,1
427,1,0,0,0,1,1,2,50,1,2,1,1,2,3,4,0
428,5,4,2,2,1,1,5,20,4,3,0,3,3,8,1,0
429,48,28,30,15,3,20,34,58.8,14,49,37,12,62,110,147,1
430,2,0,1,0,1,1,3,33.3,2,0,0,0,0,2,2,0
431,17,10,12,5,0,8,13,61.5,5,7,2,5,16,33,63,1
432,21,8,15,6,0,11,14,78.6,3,11,7,4,24,45,55,2
433,41,23,16,19,6,11,40,27.5,29,29,5,24,25,66,12,0
434,46,30,17,26,3,27,72,37.5,45,36,5,31,18,64,33,0
435,15,6,6,6,3,13,31,41.9,18,6,0,6,3,18,1,1
436,0,0,0,0,0,0,0,,0,0,0,0,0,0,0,0
437,11,8,1,6,4,3,8,37.5,5,5,2,3,3,14,12,0
438,101,57,39,50,12,39,70,55.7,31,44,8,36,57,158,35,1
439,1,1,1,0,0,0,0,,0,0,0,0,0,1,0,0
440,2,1,1,1,0,0,1,0,1,2,1,1,2,4,2,0
441,52,35,22,20,10,20,38,52.6,18,20,2,18,17,69,14,1
442,4,1,2,1,1,2,5,40,3,1,1,0,1,5,3,0
443,46,20,28,14,4,18,32,56.3,14,33,8,25,23,69,37,1
444,27,16,13,10,4,12,32,37.5,20,13,2,11,21,48,19,1
445,1,1,0,1,0,0,0,,0,0,0,0,0,1,0,0
446,36,22,20,16,0,15,30,50,15,26,10,16,36,72,40,2
447,24,14,8,12,4,10,35,28.6,25,16,1,15,10,34,12,0
448,4,4,2,2,0,0,5,0,5,2,0,2,1,5,0,0
449,83,54,33,35,15,46,91,50.5,45,25,3,22,59,142,45,1
450,30,18,13,15,2,13,31,41.9,18,11,2,9,6,36,21,0
451,27,16,9,11,7,19,55,34.5,36,23,2,21,33,60,19,0
452,56,25,32,15,9,33,60,55,27,32,3,29,22,78,38,0
453,6,4,2,3,1,1,8,12.5,7,2,0,2,1,7,0,0
454,15,13,8,6,1,6,17,35.3,11,2,0,2,3,18,2,0
455,0,0,0,0,0,0,0,,0,0,0,0,0,0,0,0
456,36,24,16,17,3,18,52,34.6,34,12,1,11,16,52,20,0
457,3,1,0,3,0,1,4,25,3,8,4,4,0,3,2,0
458,44,26,18,23,3,15,28,53.6,13,17,5,12,35,79,51,0
459,43,25,10,22,11,17,51,33.3,34,32,0,32,4,47,7,0
460,5,2,1,3,1,1,6,16.7,5,5,0,5,2,7,10,0
461,0,0,0,0,0,0,0,,0,0,0,0,0,0,0,0
462,73,40,29,36,8,30,80,37.5,50,38,10,28,43,116,26,2
463,53,24,33,16,4,19,42,45.2,23,42,15,27,27,80,87,0
464,43,29,29,12,2,28,56,50,28,25,6,19,34,77,42,0
465,1,1,1,0,0,0,3,0,3,0,0,0,1,2,19,0
466,13,7,5,4,4,3,16,18.8,13,10,0,10,5,18,17,0
467,27,16,16,8,3,15,43,34.9,28,17,2,15,25,52,28,0
468,0,0,0,0,0,0,0,,0,0,0,0,0,0,0,0
469,35,24,20,13,2,16,24,66.7,8,48,33,15,24,59,120,5
470,0,0,0,0,0,0,0,,0,0,0,0,1,1,0,0
471,34,19,16,12,6,19,44,43.2,25,26,5,21,19,53,12,2
472,7,4,2,4,1,3,13,23.1,10,9,2,7,1,8,27,0
473,43,28,21,15,7,15,26,57.7,11,22,8,14,20,63,38,2
474,49,33,20,25,4,15,40,37.5,25,18,7,11,16,65,20,0
475,46,30,25,19,2,21,37,56.8,16,31,12,19,49,95,95,0
476,79,51,45,30,4,30,67,44.8,37,65,19,46,38,117,65,3
477,89,50,52,34,3,47,78,60.3,31,54,16,38,49,138,100,2
478,0,0,0,0,0,0,1,0,1,0,0,0,1,1,2,2
479,12,6,7,4,1,3,19,15.8,16,10,5,5,9,21,5,0
480,0,0,0,0,0,0,0,,0,0,0,0,0,0,0,0
481,67,31,38,22,7,27,43,62.8,16,28,9,19,29,96,54,1
482,0,0,0,0,0,0,1,0,1,0,0,0,0,0,9,2
483,45,24,27,17,1,25,35,71.4,10,38,27,11,30,75,73,0
484,4,2,0,2,2,1,8,12.5,7,4,1,3,2,6,1,0
485,8,3,4,4,0,1,5,20,4,3,0,3,3,11,3,0
486,25,15,13,11,1,11,20,55,9,14,3,11,13,38,11,0
487,25,17,15,6,4,12,23,52.2,11,18,4,14,11,36,6,0
488,36,17,15,17,4,12,38,31.6,26,24,12,12,17,53,19,1
489,39,23,24,15,0,25,42,59.5,17,26,19,7,30,69,168,3
490,32,15,25,6,1,16,30,53.3,14,39,29,10,28,60,132,3
491,4,1,0,3,1,2,8,25,6,6,0,6,2,6,8,0
492,7,5,4,3,0,1,5,20,4,8,2,6,4,11,2,0
493,55,31,33,18,4,25,36,69.4,11,45,32,13,30,85,143,0
494,32,16,19,10,3,19,33,57.6,14,13,8,5,50,82,76,1
495,1,1,0,1,0,1,2,50,1,1,0,1,0,1,0,0
496,64,37,43,17,4,36,63,57.1,27,32,9,23,43,107,62,2
497,33,21,22,9,2,13,32,40.6,19,37,8,29,32,65,51,0
498,23,12,13,10,0,16,27,59.3,11,21,14,7,25,48,54,0
499,73,41,35,22,16,33,77,42.9,44,38,2,36,21,94,19,0
500,,0,,,,,,,,,,,1,,,
501,0,0,0,0,0,0,0,,0,0,0,0,0,0,0,0
502,12,10,8,4,0,8,10,80,2,7,4,3,9,21,28,1
503,8,3,4,4,0,2,5,40,3,4,2,2,3,11,5,1
504,0,0,0,0,0,0,0,,0,0,0,0,0,0,2,0
505,5,3,3,0,2,2,4,50,2,1,0,1,0,5,0,0
506,0,0,0,0,0,0,0,,0,0,0,0,0,0,0,0
507,1,1,1,0,0,1,1,100,0,0,0,0,0,1,0,0
508,40,27,22,18,0,24,31,77.4,7,16,6,10,19,59,43,2
509,5,3,3,1,1,3,4,75,1,6,3,3,0,5,10,0
510,16,8,10,6,0,4,6,66.7,2,14,8,6,5,21,42,0
511,16,11,6,9,1,4,25,16,21,9,2,7,8,24,4,0
512,18,12,10,8,0,11,24,45.8,13,10,3,7,19,37,28,1
513,4,2,1,0,3,2,4,50,2,6,1,5,4,8,5,0
514,44,25,32,11,1,29,40,72.5,11,42,29,13,55,99,141,0
515,49,26,19,25,5,12,55,21.8,43,32,5,27,39,88,36,0
516,4,4,2,1,1,1,3,33.3,2,2,0,2,5,9,2,1
517,2,0,1,0,1,1,2,50,1,0,0,0,1,3,0,0
518,0,0,0,0,0,0,1,0,1,0,0,0,0,0,0,0
519,6,2,1,3,2,4,9,44.4,5,2,0,2,1,7,0,0
520,14,5,6,1,7,6,15,40,9,9,1,8,9,23,9,0
521,0,0,0,0,0,0,0,,0,0,0,0,0,0,0,0
522,22,13,17,4,1,7,13,53.8,6,24,18,6,22,44,59,0
523,26,19,9,9,8,12,26,46.2,14,7,0,7,4,30,3,0
524,8,3,2,6,0,2,5,40,3,7,0,7,4,12,14,1
525,9,6,4,5,0,4,5,80,1,5,0,5,2,11,1,0
526,28,15,19,9,0,10,21,47.6,11,34,21,13,41,69,71,4
527,49,31,14,26,9,25,70,35.7,45,23,2,21,37,86,11,0
528,59,30,33,23,3,36,78,46.2,42,27,15,12,42,101,56,0
529,9,3,4,4,1,3,5,60,2,0,0,0,12,21,10,0
530,14,8,9,4,1,4,7,57.1,3,14,6,8,29,43,57,1
531,46,25,19,22,5,18,43,41.9,25,52,16,36,68,114,56,0
532,7,1,2,5,0,3,5,60,2,3,0,3,1,8,2,1
533,13,9,6,5,2,3,6,50,3,7,0,7,5,18,4,0
534,19,10,14,4,1,11,17,64.7,6,20,8,12,16,35,87,0
535,8,3,4,3,1,2,6,33.3,4,1,0,1,2,10,2,0
536,0,0,0,0,0,0,1,0,1,0,0,0,1,1,6,0
537,31,15,20,8,3,12,26,46.2,14,16,6,10,30,61,27,0
538,1,0,0,1,0,0,3,0,3,0,0,0,0,1,0,0
539,0,0,0,0,0,0,0,,0,0,0,0,1,1,0,0
540,13,10,4,7,2,9,14,64.3,5,14,11,3,13,26,43,1
541,2,0,1,0,1,1,4,25,3,7,0,7,3,5,1,0
542,63,34,33,20,10,22,55,40,33,43,1,42,73,136,51,0
543,35,17,21,10,4,7,19,36.8,12,8,3,5,26,61,32,1
544,37,20,19,17,1,18,33,54.5,15,23,6,17,18,55,19,3
545,21,10,11,9,1,10,20,50,10,7,2,5,15,36,32,0
546,31,14,23,7,1,16,28,57.1,12,46,40,6,28,59,140,0
547,34,14,17,11,6,8,18,44.4,10,11,1,10,10,44,15,0
548,3,2,1,1,1,3,4,75,1,1,0,1,2,5,7,0
549,61,36,35,16,10,33,51,64.7,18,30,11,19,32,93,80,2
550,27,12,6,16,5,12,31,38.7,19,28,2,26,6,33,11,0
551,6,1,3,2,1,1,7,14.3,6,8,0,8,3,9,2,0
552,47,36,32,14,1,22,32,68.8,10,31,19,12,80,127,135,2
553,37,15,27,8,2,17,27,63,10,38,25,13,24,61,83,2
554,14,8,1,9,4,5,16,31.3,11,14,0,14,8,22,5,0
555,5,3,4,1,0,3,6,50,3,3,2,1,2,7,6,0
556,87,56,45,33,9,40,104,38.5,64,46,6,40,33,120,30,0
557,0,0,0,0,0,0,0,,0,0,0,0,0,0,0,0
558,0,0,0,0,0,0,1,0,1,2,0,2,0,0,0,0
559,0,0,0,0,0,0,2,0,2,0,0,0,0,0,23,3
560,22,12,16,5,1,12,24,50,12,12,2,10,4,26,10,0
561,4,2,2,1,1,3,6,50,3,4,0,4,7,11,4,0
562,0,0,0,0,0,0,0,,0,0,0,0,0,0,0,0
563,41,23,27,13,1,23,33,69.7,10,29,18,11,43,84,72,2
564,1,0,1,0,0,1,1,100,0,0,0,0,0,1,0,0
565,8,4,4,4,0,3,3,100,0,5,1,4,4,12,5,0
566,26,17,9,11,6,11,20,55,9,15,5,10,19,45,11,0
567,33,20,17,11,5,24,42,57.1,18,24,3,21,13,46,36,0
568,4,3,2,2,0,1,2,50,1,4,0,4,0,4,4,0
569,20,6,6,11,3,7,20,35,13,17,4,13,17,37,29,1
570,16,9,7,5,4,7,15,46.7,8,13,4,9,10,26,14,0
571,3,1,1,0,2,3,4,75,1,0,0,0,1,4,1,0
572,12,7,7,5,0,3,6,50,3,4,0,4,8,20,6,0
573,16,8,5,10,1,7,29,24.1,22,25,2,23,10,26,4,0
574,11,5,2,6,3,1,13,7.7,12,8,1,7,3,14,2,0
575,35,23,26,6,3,14,29,48.3,15,20,5,15,19,54,27,0
576,15,4,6,7,2,6,18,33.3,12,14,1,13,11,26,18,1
577,22,12,9,6,7,11,26,42.3,15,12,0,12,13,35,5,0
578,0,0,0,0,0,0,0,,0,1,0,1,0,0,0,0
579,27,16,11,9,7,14,41,34.1,27,12,1,11,3,30,9,0
580,35,26,23,7,5,23,31,74.2,8,22,7,15,23,58,55,0
581,1,0,1,0,0,1,2,50,1,0,0,0,0,1,6,3
582,45,25,24,14,7,18,36,50,18,31,9,22,22,67,64,1
583,5,1,1,1,3,0,4,0,4,2,2,0,0,5,11,0
584,58,32,29,26,3,24,62,38.7,38,40,13,27,22,80,27,0
585,15,12,8,5,2,7,20,35,13,9,0,9,11,26,9,0
586,27,15,14,11,2,9,19,47.4,10,14,2,12,4,31,10,0
587,1,0,1,0,0,1,2,50,1,0,0,0,0,1,9,1
588,17,12,4,11,2,6,21,28.6,15,11,1,10,7,24,4,0
589,6,3,3,3,0,3,11,27.3,8,3,0,3,4,10,3,0
590,80,47,50,23,7,35,65,53.8,30,35,19,16,38,118,82,1
591,3,3,2,1,0,3,3,100,0,0,0,0,1,4,14,1
592,28,18,18,6,4,13,25,52,12,31,18,13,35,63,66,0
593,5,2,1,4,0,3,3,100,0,1,1,0,2,7,6,0
594,37,21,19,14,4,16,25,64,9,22,12,10,39,76,57,0
595,79,39,31,39,9,37,69,53.6,32,31,5,26,40,119,45,0
596,0,0,0,0,0,0,0,,0,0,0,0,0,0,0,0
597,1,0,0,0,1,0,0,,0,0,0,0,0,1,1,0
598,21,13,7,11,3,11,29,37.9,18,27,8,19,24,45,42,0
599,0,0,0,0,0,0,1,0,1,0,0,0,0,0,0,0
600,28,21,15,12,1,8,16,50,8,15,12,3,16,44,58,1
601,48,23,30,13,5,30,55,54.5,25,23,5,18,29,77,34,0
602,13,5,5,5,3,5,27,18.5,22,13,1,12,5,18,9,0
603,93,62,43,32,18,44,71,62,27,42,14,28,30,123,74,0
604,0,0,0,0,0,0,0,,0,0,0,0,0,0,0,0
605,46,32,30,15,1,21,28,75,7,29,14,15,39,85,155,0
606,23,9,7,12,4,10,28,35.7,18,14,0,14,12,35,5,0
607,1,1,0,1,0,0,0,,0,0,0,0,0,1,0,0
608,4,3,0,4,0,1,1,100,0,0,0,0,1,5,1,0
609,19,12,3,11,5,5,20,25,15,18,2,16,6,25,9,0
610,0,0,0,0,0,0,0,,0,0,0,0,0,0,0,0
611,5,2,0,3,2,1,9,11.1,8,11,1,10,5,10,1,0
612,33,17,12,18,3,13,32,40.6,19,16,6,10,10,43,14,2
613,29,18,18,9,2,14,28,50,14,23,13,10,19,48,53,2
614,0,0,0,0,0,0,2,0,2,0,0,0,3,3,3,1
615,30,15,21,8,1,11,22,50,11,21,10,11,8,38,20,0
616,13,7,2,7,4,6,11,54.5,5,2,0,2,1,14,2,0
617,17,11,5,8,4,9,18,50,9,13,0,13,1,18,3,0
618,13,9,7,5,1,5,9,55.6,4,15,10,5,22,35,53,1
619,18,10,3,5,10,4,17,23.5,13,10,0,10,5,23,4,0
620,4,2,2,2,0,3,6,50,3,4,2,2,2,6,1,0
621,0,0,0,0,0,0,0,,0,0,0,0,0,0,2,0
622,42,19,10,24,8,20,46,43.5,26,18,3,15,17,59,16,0
623,15,10,2,8,5,2,19,10.5,17,7,0,7,2,17,8,0
624,93,55,58,31,4,56,105,53.3,49,45,14,31,57,150,63,2
625,55,41,35,12,8,31,57,54.4,26,24,13,11,29,84,59,0
626,27,13,12,11,4,20,36,55.6,16,16,1,15,7,34,7,0
627,46,31,26,17,3,34,43,79.1,9,13,7,6,14,60,34,1
628,37,26,20,13,4,18,28,64.3,10,21,12,9,32,69,53,1
629,7,6,3,0,4,2,4,50,2,5,0,5,2,9,3,0
630,41,29,29,12,0,23,34,67.6,11,38,25,13,40,81,111,0
631,42,29,30,12,0,23,33,69.7,10,43,27,16,49,91,96,1
632,1,1,0,1,0,0,0,,0,0,0,0,1,2,0,1
633,10,4,8,2,0,8,18,44.4,10,16,6,10,20,30,33,2
634,45,22,16,19,10,18,54,33.3,36,16,1,15,26,71,32,1
635,32,18,15,13,4,13,32,40.6,19,22,3,19,20,52,17,2
636,0,0,0,0,0,0,0,,0,0,0,0,0,0,5,1
637,32,16,17,9,6,16,41,39,25,16,1,15,19,51,25,0
638,2,1,0,1,1,1,2,50,1,3,0,3,1,3,7,0
639,24,9,7,11,6,9,30,30,21,14,4,10,5,29,15,0
640,34,17,17,8,9,13,31,41.9,18,27,1,26,23,57,26,1
641,36,21,20,12,4,13,26,50,13,32,19,13,30,66,75,1
642,3,1,1,1,1,2,5,40,3,2,1,1,2,5,9,0
643,0,0,0,0,0,0,0,,0,0,0,0,0,0,0,0
644,30,18,16,10,4,16,25,64,9,14,11,3,21,51,53,0
645,29,17,20,8,1,14,25,56,11,59,52,7,29,58,139,0
646,32,16,4,15,13,12,37,32.4,25,32,2,30,6,38,16,0
647,11,7,8,2,1,7,11,63.6,4,5,0,5,2,13,4,0
648,5,1,4,1,0,1,9,11.1,8,6,5,1,1,6,9,0
649,0,0,0,0,0,0,0,,0,0,0,0,0,0,0,0
650,55,30,22,25,8,30,60,50,30,24,3,21,21,76,17,2
651,24,12,7,9,8,11,24,45.8,13,10,0,10,10,34,30,0
652,23,14,13,8,2,9,31,29,22,25,7,18,26,49,52,0
653,0,0,0,0,0,0,0,,0,0,0,0,0,0,0,0
654,0,0,0,0,0,0,1,0,1,0,0,0,0,0,2,0
655,15,9,4,8,3,6,16,37.5,10,11,1,10,4,19,11,0
656,47,22,15,25,7,23,58,39.7,35,28,10,18,26,73,45,0
657,2,1,0,1,1,2,2,100,0,0,0,0,1,3,0,0
658,27,16,3,17,7,12,31,38.7,19,12,0,12,7,34,3,0
659,48,35,34,12,2,22,42,52.4,20,20,7,13,27,75,31,0
660,41,24,17,21,3,16,30,53.3,14,19,10,9,13,54,35,0
661,0,0,0,0,0,0,0,,0,0,0,0,0,0,0,0
662,0,0,0,0,0,0,0,,0,0,0,0,0,0,0,0
663,8,6,3,2,3,2,8,25,6,1,0,1,1,9,1,1
664,6,4,4,2,0,5,14,35.7,9,6,2,4,4,10,14,0
665,15,9,3,5,7,7,12,58.3,5,13,4,9,9,24,14,0
666,2,0,0,1,1,0,1,0,1,1,0,1,0,2,4,0
667,18,15,10,7,1,8,21,38.1,13,12,5,7,14,32,10,0
668,18,9,5,5,8,6,15,40,9,13,0,13,8,26,30,1
669,24,16,6,10,8,7,23,30.4,16,8,0,8,8,32,3,0
670,3,1,1,1,1,2,5,40,3,1,0,1,2,5,1,0
671,31,17,18,12,1,15,28,53.6,13,26,14,12,58,89,68,1
672,52,31,19,30,3,16,41,39,25,32,9,23,33,85,21,0
673,12,6,4,4,4,1,10,10,9,14,1,13,1,13,7,0
674,21,12,4,13,4,10,21,47.6,11,11,2,9,9,30,2,0
675,11,4,8,3,0,6,7,85.7,1,8,7,1,16,27,52,0
676,42,17,25,14,3,22,50,44,28,37,10,27,9,51,38,1
677,51,35,20,22,9,17,52,32.7,35,36,2,34,15,66,13,0
678,12,7,6,4,2,1,7,14.3,6,9,2,7,8,20,14,0
679,3,1,1,2,0,0,2,0,2,2,1,1,1,4,2,0
680,1,0,1,0,0,0,0,,0,0,0,0,1,2,2,0
681,0,0,0,0,0,0,3,0,3,0,0,0,0,0,1,3
682,32,15,21,10,1,13,18,72.2,5,22,4,18,2,34,18,0
683,9,4,1,4,4,1,6,16.7,5,14,1,13,2,11,16,0
684,11,6,2,3,6,7,29,24.1,22,14,0,14,9,20,4,0
685,39,24,20,14,5,19,40,47.5,21,37,8,29,21,60,26,1
686,0,0,0,0,0,0,1,0,1,0,0,0,1,1,0,0
687,0,0,0,0,0,0,0,,0,0,0,0,0,0,0,0
688,16,5,2,8,6,9,23,39.1,14,17,1,16,9,25,11,0
689,58,36,30,20,8,33,58,56.9,25,28,10,18,38,96,46,1
690,29,18,6,13,10,14,37,37.8,23,17,0,17,6,35,3,0
691,1,1,0,1,0,0,0,,0,2,1,1,0,1,0,0
692,17,7,5,10,2,9,25,36,16,16,8,8,22,39,25,0
693,8,6,3,4,1,2,5,40,3,6,1,5,5,13,4,0
694,20,11,8,9,3,5,38,13.2,33,11,0,11,8,28,2,0
695,0,0,0,0,0,0,1,0,1,0,0,0,2,2,2,0
696,35,24,18,15,2,13,23,56.5,10,29,17,12,30,65,87,3
697,0,0,0,0,0,0,1,0,1,0,0,0,0,0,0,0
698,22,14,10,9,3,8,14,57.1,6,6,2,4,10,32,19,1
699,9,5,0,8,1,0,8,0,8,13,4,9,4,13,11,0
700,22,11,10,9,3,10,24,41.7,14,7,0,7,9,31,10,0
701,2,1,1,1,0,1,1,100,0,0,0,0,0,2,0,0
702,11,9,7,3,1,5,10,50,5,4,0,4,7,18,1,0
703,26,19,11,12,3,8,15,53.3,7,19,13,6,23,49,66,0
704,3,2,1,0,2,1,3,33.3,2,2,0,2,1,4,0,0
705,7,2,5,2,0,1,3,33.3,2,2,0,2,0,7,1,0
706,23,17,3,11,9,8,22,36.4,14,11,0,11,8,31,4,0
707,0,0,0,0,0,0,0,,0,0,0,0,0,0,0,0
708,9,7,3,5,1,2,8,25,6,7,0,7,4,13,2,0
709,23,15,14,9,0,12,25,48,13,19,11,8,17,40,71,1
710,6,2,0,4,2,4,7,57.1,3,4,1,3,1,7,1,0
711,17,11,5,5,7,4,14,28.6,10,7,0,7,5,22,8,0
712,15,9,6,8,1,7,14,50,7,37,32,5,27,42,142,1
713,3,2,2,1,0,0,1,0,1,2,0,2,1,4,0,0
714,13,10,8,3,2,9,19,47.4,10,15,8,7,23,36,40,0
715,33,19,26,4,3,21,28,75,7,16,5,11,14,47,30,0
716,15,6,6,6,3,5,12,41.7,7,11,2,9,3,18,10,1
717,13,4,2,8,3,7,24,29.2,17,14,1,13,11,24,5,0
718,3,1,1,2,0,1,1,100,0,1,0,1,0,3,0,0
719,28,15,10,15,3,13,24,54.2,11,6,1,5,19,47,19,0
720,2,2,1,1,0,1,4,25,3,0,0,0,1,3,7,0
721,0,0,0,0,0,0,0,,0,0,0,0,1,1,14,3
722,9,4,3,4,2,2,3,66.7,1,5,3,2,2,11,1,0
723,23,11,10,12,1,10,18,55.6,8,7,1,6,9,32,3,0
724,6,3,4,2,0,5,6,83.3,1,6,6,0,12,18,26,0
725,10,8,5,5,0,4,11,36.4,7,14,13,1,7,17,44,0
726,38,20,12,19,7,15,47,31.9,32,10,0,10,23,61,4,0
727,1,1,1,0,0,1,1,100,0,1,0,1,0,1,0,0
728,1,1,1,0,0,1,1,100,0,0,0,0,0,1,0,0
729,42,27,20,21,1,23,39,59,16,40,30,10,26,68,75,0
730,0,0,0,0,0,0,0,,0,0,0,0,0,0,0,0
731,0,0,0,0,0,0,0,,0,0,0,0,0,0,10,5
732,60,39,39,19,2,26,39,66.7,13,26,10,16,24,84,71,0
733,44,26,24,16,4,23,34,67.6,11,24,5,19,59,103,109,2
734,9,3,3,5,1,3,11,27.3,8,6,1,5,2,11,6,1
735,48,29,21,23,4,14,18,77.8,4,20,9,11,34,82,60,0
736,50,37,33,13,4,18,35,51.4,17,30,13,17,61,111,90,2
737,3,3,1,2,0,2,2,100,0,1,0,1,1,4,2,0
738,43,24,21,20,2,29,46,63,17,21,11,10,31,74,56,0
739,0,0,0,0,0,0,0,,0,0,0,0,1,1,14,2
740,7,3,2,2,3,4,8,50,4,3,0,3,2,9,2,0
741,0,0,0,0,0,0,0,,0,0,0,0,0,0,3,1
742,2,1,0,1,1,1,2,50,1,0,0,0,0,2,0,0
743,18,12,5,11,2,8,14,57.1,6,11,2,9,13,31,20,0
744,10,5,3,5,2,3,6,50,3,4,0,4,3,13,0,0
745,9,4,4,3,2,3,9,33.3,6,15,1,14,6,15,17,0
746,0,0,0,0,0,0,0,,0,0,0,0,0,0,3,1
747,6,2,2,4,0,2,3,66.7,1,3,0,3,3,9,0,0
748,4,1,4,0,0,4,6,66.7,2,2,1,1,4,8,21,0
749,0,0,0,0,0,0,0,,0,0,0,0,0,0,1,0
750,76,45,36,32,8,32,76,42.1,44,38,9,29,32,108,34,1
751,7,4,4,2,1,5,8,62.5,3,5,3,2,3,10,3,0
752,2,1,0,2,0,1,3,33.3,2,2,0,2,2,4,1,0
753,8,7,4,2,2,2,6,33.3,4,3,0,3,0,8,1,0
754,0,0,0,0,0,0,0,,0,0,0,0,0,0,9,2
755,76,47,47,23,6,30,60,50,30,34,12,22,35,111,36,3
756,50,30,36,12,2,30,41,73.2,11,34,26,8,13,63,112,4
757,36,17,15,14,7,15,43,34.9,28,14,0,14,5,41,7,0
758,0,0,0,0,0,0,0,,0,0,0,0,1,1,0,0
759,75,43,30,37,8,32,71,45.1,39,33,8,25,28,103,32,0
760,75,43,34,34,7,35,79,44.3,44,30,7,23,68,143,24,0
761,12,9,9,3,0,9,11,81.8,2,1,0,1,4,16,6,0
762,0,0,0,0,0,0,0,,0,0,0,0,0,0,1,0
763,8,2,2,5,1,5,13,38.5,8,9,3,6,3,11,3,0
764,0,0,0,0,0,0,1,0,1,0,0,0,0,0,0,0
765,30,20,16,9,5,13,27,48.1,14,25,4,21,39,69,51,0
766,18,7,8,7,3,9,32,28.1,23,10,1,9,7,25,4,0
767,0,0,0,0,0,0,0,,0,0,0,0,1,1,5,2
768,4,3,2,2,0,2,6,33.3,4,8,4,4,10,14,33,0
769,5,4,2,3,0,4,10,40,6,7,3,4,13,18,17,0
770,4,2,3,1,0,1,3,33.3,2,0,0,0,1,5,4,0
771,3,2,0,3,0,0,4,0,4,3,0,3,5,8,3,0
772,1,1,1,0,0,1,1,100,0,0,0,0,0,1,9,0
773,18,14,9,9,0,6,11,54.5,5,27,20,7,22,40,82,0
774,18,8,12,6,0,8,23,34.8,15,18,9,9,24,42,102,0
775,76,47,43,27,6,43,85,50.6,42,40,6,34,57,133,82,0
776,43,27,22,14,7,27,46,58.7,19,27,3,24,22,65,35,1
777,1,1,1,0,0,0,1,0,1,0,0,0,0,1,8,2
778,23,16,4,12,7,6,23,26.1,17,14,2,12,17,40,9,0
779,17,6,5,8,4,3,14,21.4,11,8,0,8,10,27,4,0
780,15,12,12,3,0,8,14,57.1,6,24,18,6,16,31,76,1
781,0,0,0,0,0,0,0,,0,1,0,1,4,4,4,0
782,32,12,9,14,9,16,32,50,16,15,6,9,9,41,26,0
783,7,3,3,4,0,5,8,62.5,3,5,0,5,3,10,5,0
784,34,19,13,16,5,11,32,34.4,21,32,3,29,10,44,7,0
785,10,8,5,5,0,5,11,45.5,6,32,28,4,27,37,113,3
786,13,7,6,5,2,10,13,76.9,3,8,1,7,10,23,7,0
787,0,0,0,0,0,0,0,,0,0,0,0,0,0,0,0
788,25,19,11,13,1,15,38,39.5,23,24,2,22,4,29,20,1
789,71,44,43,21,7,42,90,46.7,48,40,5,35,53,124,92,0
790,30,13,7,14,9,8,35,22.9,27,19,0,19,9,39,4,3
791,14,8,7,4,3,8,25,32,17,22,5,17,4,18,35,0
792,25,14,19,6,0,11,19,57.9,8,19,9,10,15,40,42,0
793,28,12,16,8,4,10,18,55.6,8,13,3,10,16,44,38,1
794,2,1,2,0,0,0,2,0,2,0,0,0,0,2,12,0
795,29,18,11,14,4,14,26,53.8,12,11,2,9,19,48,8,0
796,16,10,2,7,7,7,21,33.3,14,20,5,15,0,16,18,0
797,1,1,1,0,0,1,1,100,0,0,0,0,0,1,0,0
798,48,28,17,25,6,22,50,44,28,35,11,24,30,78,32,1
799,1,0,0,1,0,0,0,,0,1,0,1,0,1,0,0
800,32,18,27,5,0,15,24,62.5,9,13,4,9,9,41,26,0
801,0,0,0,0,0,0,1,0,1,1,1,0,2,2,2,0
802,43,28,17,21,5,26,56,46.4,30,27,7,20,29,72,25,0
803,18,10,8,6,4,4,11,36.4,7,9,2,7,6,24,15,0
804,8,3,2,6,0,2,7,28.6,5,9,2,7,4,12,5,0
805,19,12,2,12,5,7,23,30.4,16,19,5,14,9,28,6,0
806,26,20,12,12,2,15,29,51.7,14,17,1,16,9,35,7,0
807,19,10,5,5,9,11,25,44,14,9,0,9,7,26,10,0
808,3,0,1,1,1,0,6,0,6,8,1,7,4,7,2,0
809,25,15,10,10,5,12,28,42.9,16,13,2,11,8,33,17,0
810,16,8,10,5,1,7,12,58.3,5,7,1,6,14,30,13,0
811,21,14,16,5,0,10,20,50,10,19,13,6,29,50,86,0
812,40,24,23,17,0,22,36,61.1,14,33,22,11,34,74,83,1
813,18,10,9,6,3,6,16,37.5,10,7,0,7,4,22,4,0
814,36,17,14,15,7,11,39,28.2,28,23,2,21,12,48,28,0
815,44,29,22,15,7,26,69,37.7,43,35,3,32,19,63,30,0
816,16,11,1,12,3,3,8,37.5,5,14,2,12,6,22,7,0
817,72,47,50,16,6,36,67,53.7,31,25,2,23,22,94,92,1
818,3,3,2,1,0,1,2,50,1,1,0,1,2,5,1,0
819,1,0,0,1,0,0,4,0,4,2,1,1,0,1,1,0
820,10,5,5,2,3,4,11,36.4,7,9,1,8,4,14,18,0
821,1,1,1,0,0,0,0,,0,1,0,1,0,1,0,0
822,73,41,34,34,5,31,72,43.1,41,43,12,31,30,103,64,0
823,13,6,4,5,4,8,17,47.1,9,9,1,8,9,22,14,0
824,28,16,18,10,0,10,18,55.6,8,54,39,15,28,56,122,1
825,1,0,1,0,0,1,1,100,0,2,1,1,1,2,0,0
826,30,14,9,20,1,13,34,38.2,21,27,2,25,21,51,28,0
827,0,0,0,0,0,0,1,0,1,0,0,0,0,0,4,0
828,46,24,25,17,4,26,54,48.1,28,18,3,15,26,72,35,0
829,107,63,58,39,10,44,112,39.3,68,45,10,35,54,161,87,1
830,0,0,0,0,0,0,1,0,1,0,0,0,0,0,2,0
831,1,1,0,1,0,1,1,100,0,0,0,0,0,1,0,0
832,27,18,22,4,1,15,27,55.6,12,31,24,7,22,49,69,1
833,36,22,20,11,5,17,24,70.8,7,13,5,8,25,61,29,2
834,11,8,7,4,0,3,8,37.5,5,3,1,2,5,16,5,0
835,24,14,14,8,2,14,22,63.6,8,17,13,4,20,44,59,0
836,10,6,5,2,3,6,11,54.5,5,4,1,3,5,15,1,0
837,17,9,9,5,3,5,8,62.5,3,3,0,3,9,26,0,0
838,0,0,0,0,0,0,0,,0,0,0,0,0,0,11,0
839,46,25,17,23,6,24,70,34.3,46,33,10,23,39,85,25,1
840,61,40,31,23,7,36,74,48.6,38,29,7,22,35,96,31,1
841,1,0,0,1,0,1,1,100,0,0,0,0,1,2,0,0
842,40,24,30,9,1,25,33,75.8,8,47,37,10,53,93,169,2
843,0,0,0,0,0,0,1,0,1,2,0,2,0,0,0,0
844,10,4,2,6,2,4,13,30.8,9,4,0,4,3,13,2,0
845,30,18,12,13,5,12,30,40,18,11,0,11,13,43,10,0
846,2,1,0,1,1,1,4,25,3,4,1,3,2,4,11,0
847,2,2,2,0,0,0,0,,0,0,0,0,1,3,1,0
848,0,0,0,0,0,0,0,,0,0,0,0,1,1,5,0
849,32,19,24,8,0,17,32,53.1,15,26,16,10,24,56,82,0
850,1,1,1,0,0,0,0,,0,2,0,2,0,1,0,0
851,1,0,1,0,0,1,1,100,0,0,0,0,0,1,0,0
852,62,40,38,21,3,29,62,46.8,33,38,5,33,23,85,62,1
853,4,2,1,3,0,0,4,0,4,8,3,5,8,12,11,0
854,1,1,0,1,0,1,3,33.3,2,0,0,0,0,1,0,0
855,0,0,0,0,0,0,0,,0,0,0,0,0,0,4,0
856,4,3,1,3,0,1,5,20,4,0,0,0,2,6,0,0
857,1,0,0,0,1,0,1,0,1,0,0,0,1,2,0,0
858,3,2,0,2,1,1,1,100,0,4,0,4,1,4,0,0
859,10,6,3,3,4,6,13,46.2,7,12,1,11,5,15,6,0
860,1,1,0,0,1,0,0,,0,0,0,0,0,1,2,0
861,17,11,10,6,1,9,12,75,3,21,16,5,27,44,67,1
862,4,1,0,4,0,2,4,50,2,0,0,0,0,4,0,0
863,0,0,0,0,0,0,1,0,1,0,0,0,2,2,0,0
864,43,29,5,25,13,7,36,19.4,29,14,0,14,7,50,7,0
865,20,15,11,8,1,8,18,44.4,10,17,11,6,28,48,77,0
866,41,23,21,16,4,20,34,58.8,14,40,33,7,33,74,102,1
867,5,2,1,4,0,1,5,20,4,4,1,3,7,12,8,0
868,9,6,6,3,0,6,11,54.5,5,13,8,5,9,18,33,0
869,35,22,23,10,2,21,37,56.8,16,24,8,16,37,72,51,0
870,0,0,0,0,0,0,0,,0,0,0,0,0,0,0,0
871,0,0,0,0,0,0,0,,0,0,0,0,0,0,0,0
872,54,28,26,22,6,26,91,28.6,65,36,0,36,17,71,42,2
873,2,0,1,1,0,1,4,25,3,2,2,0,2,4,6,0
874,2,1,2,0,0,2,2,100,0,0,0,0,0,2,7,0
875,47,31,22,17,8,21,61,34.4,40,30,7,23,30,77,31,0
876,0,0,0,0,0,0,0,,0,0,0,0,0,0,5,2
877,3,0,3,0,0,2,5,40,3,10,10,0,4,7,28,0
878,21,10,7,10,4,9,27,33.3,18,8,2,6,8,29,13,1
879,24,17,14,9,1,12,33,36.4,21,21,13,8,29,53,32,2
880,40,22,28,9,3,19,33,57.6,14,31,22,9,39,79,63,1
881,32,18,15,9,8,12,25,48,13,24,12,12,18,50,46,0
882,55,35,28,23,4,29,87,33.3,58,21,5,16,30,85,35,0
883,7,5,2,2,3,2,4,50,2,6,5,1,7,14,12,0
884,44,23,18,17,9,14,57,24.6,43,9,1,8,7,51,20,0
885,10,8,5,4,1,4,8,50,4,7,2,5,4,14,6,0
886,3,1,0,2,1,2,4,50,2,5,1,4,2,5,8,0
887,21,13,11,6,4,13,27,48.1,14,14,4,10,11,32,12,0
888,0,0,0,0,0,0,0,,0,0,0,0,0,0,1,0
889,23,14,5,8,10,3,16,18.8,13,20,0,20,4,27,3,0
890,61,29,30,26,5,31,59,52.5,28,22,6,16,24,85,37,0
891,0,0,0,0,0,0,2,0,2,1,0,1,2,2,10,1
892,2,1,1,1,0,1,1,100,0,1,1,0,0,2,0,0
893,37,21,21,9,7,22,45,48.9,23,21,0,21,24,61,17,0
894,28,14,14,7,7,14,32,43.8,18,9,2,7,27,55,10,1
895,16,8,10,4,2,7,17,41.2,10,9,0,9,11,27,5,0
896,1,1,0,1,0,1,2,50,1,2,1,1,1,2,2,0
897,27,19,11,13,3,12,58,20.7,46,24,2,22,26,53,17,1
898,12,8,11,1,0,7,11,63.6,4,5,2,3,12,24,26,1
899,69,43,19,41,9,29,56,51.8,27,29,7,22,32,101,22,2
900,28,19,12,13,3,18,40,45,22,26,4,22,33,61,35,0
901,2,0,1,0,1,0,1,0,1,3,3,0,2,4,4,0
902,5,3,3,2,0,1,5,20,4,3,1,2,10,15,10,0
903,23,12,14,7,2,11,25,44,14,39,32,7,44,67,159,1
904,0,0,0,0,0,0,1,0,1,1,0,1,0,0,1,0
905,54,28,21,21,12,22,84,26.2,62,49,2,47,27,81,16,1
906,21,12,2,11,8,7,22,31.8,15,18,0,18,2,23,2,1
907,53,23,21,27,5,21,54,38.9,33,17,1,16,19,72,12,2
908,3,3,0,2,1,2,4,50,2,5,0,5,1,4,0,0
909,1,0,1,0,0,0,1,0,1,0,0,0,0,1,23,2
910,20,13,4,12,4,11,26,42.3,15,12,1,11,3,23,2,0
911,3,2,0,2,1,2,5,40,3,1,0,1,0,3,2,0
912,2,0,2,0,0,1,2,50,1,2,1,1,0,2,4,0
913,0,0,0,0,0,0,3,0,3,0,0,0,0,0,9,4
914,0,0,0,0,0,0,0,,0,1,0,1,0,0,0,0
915,5,3,3,1,1,4,4,100,0,1,0,1,2,7,2,0
916,0,0,0,0,0,0,1,0,1,2,1,1,1,1,2,0
917,36,17,17,15,4,21,34,61.8,13,19,3,16,29,65,49,0
918,69,49,35,28,6,35,47,74.5,12,29,7,22,20,89,50,0
919,0,0,0,0,0,0,1,0,1,1,0,1,1,1,0,0
920,26,19,12,10,4,13,27,48.1,14,8,2,6,9,35,25,0
921,57,39,22,27,8,36,74,48.6,38,27,0,27,28,85,52,0
922,5,3,4,0,1,0,1,0,1,4,0,4,7,12,11,0
923,24,10,8,12,4,12,43,27.9,31,18,6,12,23,47,23,0
924,10,3,5,3,2,5,13,38.5,8,11,1,10,11,21,11,0
925,46,16,26,18,2,26,52,50,26,44,12,32,29,75,62,1
926,63,27,32,24,7,22,79,27.8,57,38,11,27,32,95,24,0
927,2,2,2,0,0,0,1,0,1,2,1,1,4,6,6,0
928,40,24,19,13,8,13,29,44.8,16,19,2,17,17,57,7,1
929,69,39,22,33,14,30,70,42.9,40,48,8,40,35,104,26,1
930,14,8,10,4,0,9,11,81.8,2,5,3,2,5,19,26,0
931,17,5,14,3,0,10,16,62.5,6,13,7,6,23,40,47,0
932,32,18,19,12,1,12,23,52.2,11,24,6,18,17,49,40,2
933,0,0,0,0,0,0,0,,0,0,0,0,0,0,0,0
934,33,15,14,11,8,10,51,19.6,41,11,1,10,12,45,13,0
935,5,4,3,2,0,3,3,100,0,3,3,0,4,9,7,0
936,28,16,10,10,8,18,39,46.2,21,31,2,29,8,36,9,0
937,35,25,8,18,9,14,44,31.8,30,21,5,16,22,57,5,1
938,0,0,0,0,0,0,0,,0,0,0,0,0,0,8,1
939,0,0,0,0,0,0,2,0,2,0,0,0,0,0,1,0
940,4,3,1,3,0,0,4,0,4,2,2,0,8,12,12,0
941,6,4,3,2,1,1,7,14.3,6,5,2,3,3,9,10,0
942,3,3,1,1,1,3,3,100,0,1,0,1,1,4,2,0
943,1,1,1,0,0,1,2,50,1,0,0,0,2,3,0,0
944,0,0,0,0,0,0,0,,0,1,0,1,0,0,1,0
945,12,6,7,4,1,1,13,7.7,12,14,5,9,9,21,7,0
946,23,12,16,4,3,16,27,59.3,11,15,8,7,28,51,52,0
947,108,66,60,37,11,42,99,42.4,57,48,8,40,45,153,52,0
948,40,21,14,21,5,14,30,46.7,16,16,2,14,20,60,21,0
949,2,1,1,0,1,0,1,0,1,0,0,0,0,2,0,0
950,28,12,6,16,6,12,35,34.3,23,16,2,14,8,36,9,1
951,12,6,3,3,6,2,12,16.7,10,15,2,13,6,18,9,0
952,69,38,35,20,14,21,69,30.4,48,58,9,49,29,98,26,0
953,3,0,3,0,0,1,1,100,0,0,0,0,2,5,12,1
954,59,36,40,16,3,30,61,49.2,31,22,7,15,32,91,35,1
955,19,10,5,9,5,6,18,33.3,12,22,1,21,6,25,1,0
956,60,36,24,24,12,18,44,40.9,26,23,4,19,24,84,13,0
957,3,2,1,2,0,2,6,33.3,4,4,0,4,2,5,3,0
958,0,0,0,0,0,0,1,0,1,0,0,0,0,0,1,0
959,42,23,15,18,9,8,35,22.9,27,27,3,24,42,84,24,0
960,36,22,15,17,4,14,47,29.8,33,27,10,17,24,60,41,1
961,28,14,15,11,2,12,22,54.5,10,27,21,6,52,80,168,0
962,27,18,13,13,1,11,26,42.3,15,22,12,10,44,71,53,3
963,60,35,44,12,4,39,73,53.4,34,34,8,26,45,105,53,0
964,0,0,0,0,0,0,0,,0,0,0,0,1,1,1,2
965,18,9,6,9,3,9,27,33.3,18,8,2,6,13,31,4,0
966,27,17,6,11,10,8,36,22.2,28,30,4,26,9,36,21,0
967,43,26,12,23,8,16,49,32.7,33,31,4,27,24,67,16,0
968,1,1,1,0,0,0,0,,0,0,0,0,0,1,0,0
969,21,12,14,6,1,14,17,82.4,3,19,11,8,22,43,78,0
970,0,0,0,0,0,0,1,0,1,0,0,0,0,0,0,0
971,10,4,2,5,3,6,10,60,4,6,3,3,6,16,15,0
972,0,0,0,0,0,0,0,,0,1,1,0,0,0,0,0
973,56,34,26,25,5,27,74,36.5,47,45,11,34,53,109,49,1
974,38,18,13,18,7,9,33,27.3,24,36,0,36,25,63,13,0
975,1,0,0,1,0,0,1,0,1,0,0,0,1,2,0,0
976,1,1,1,0,0,0,2,0,2,0,0,0,1,2,1,0
977,0,0,0,0,0,0,0,,0,0,0,0,0,0,11,2
978,15,8,13,2,0,7,14,50,7,12,7,5,11,26,29,0
979,34,23,9,20,5,17,30,56.7,13,15,1,14,14,48,7,1
980,4,3,1,0,3,2,10,20,8,9,0,9,0,4,3,0
981,0,0,0,0,0,0,0,,0,0,0,0,0,0,0,0
982,42,20,18,17,7,22,36,61.1,14,24,1,23,25,67,25,1
983,23,14,6,11,6,8,31,25.8,23,13,1,12,9,32,27,0
984,42,17,16,20,6,8,35,22.9,27,26,4,22,16,58,16,2
985,8,5,4,2,2,5,12,41.7,7,5,0,5,6,14,5,0
986,5,4,2,1,2,0,4,0,4,3,1,2,0,5,4,0
987,0,0,0,0,0,0,0,,0,0,0,0,0,0,0,0
988,4,4,2,2,0,2,7,28.6,5,6,0,6,1,5,2,0
989,1,1,1,0,0,1,1,100,0,3,0,3,0,1,0,0
990,0,0,0,0,0,0,0,,0,1,0,1,0,0,0,0
991,17,12,8,6,3,9,14,64.3,5,11,5,6,10,27,12,1
992,17,10,8,6,3,9,15,60,6,2,0,2,3,20,16,0
993,3,1,1,2,0,0,3,0,3,2,1,1,3,6,10,0
994,36,21,17,17,2,24,36,66.7,12,22,6,16,19,55,41,1
995,0,0,0,0,0,0,0,,0,1,0,1,0,0,0,0
996,23,16,17,6,0,7,12,58.3,5,36,30,6,27,50,139,2
997,24,17,10,11,3,15,38,39.5,23,26,4,22,18,42,29,1
998,2,0,2,0,0,2,7,28.6,5,0,0,0,3,5,11,5
999,52,35,27,20,5,25,46,54.3,21,33,9,24,19,71,33,2
1000,1,0,1,0,0,0,1,0,1,0,0,0,1,2,1,0
1001,41,21,16,21,4,14,52,26.9,38,21,4,17,17,58,29,0
1002,0,0,0,0,0,0,0,,0,0,0,0,0,0,0,0
1003,36,22,20,13,3,27,40,67.5,13,21,10,11,33,69,76,0
1004,7,5,3,2,2,4,10,40,6,8,0,8,4,11,5,0
1005,0,0,0,0,0,0,1,0,1,0,0,0,0,0,0,0
1006,14,6,10,4,0,7,22,31.8,15,24,14,10,37,51,68,1
1007,85,52,49,32,4,52,103,50.5,51,67,33,34,69,154,143,0
1008,15,11,4,6,5,3,17,17.6,14,13,4,9,3,18,19,0
1009,47,31,16,20,11,22,57,38.6,35,26,0,26,14,61,3,0
1010,47,32,29,14,4,24,39,61.5,15,41,19,22,15,62,100,2
1011,18,7,13,3,2,10,15,66.7,5,7,5,2,13,31,46,0
1012,12,5,7,5,0,4,11,36.4,7,8,5,3,22,34,23,0
1013,0,0,0,0,0,0,0,,0,0,0,0,0,0,0,0
1014,40,22,10,18,12,18,41,43.9,23,26,1,25,12,52,8,0
1015,16,4,6,6,4,8,32,25,24,8,2,6,1,17,7,1
1016,23,13,6,12,5,10,15,66.7,5,4,0,4,3,26,4,0
1017,11,7,10,1,0,7,9,77.8,2,6,3,3,8,19,15,0
1018,7,4,3,2,2,4,12,33.3,8,3,0,3,3,10,5,0
1019,10,6,5,2,3,5,9,55.6,4,4,1,3,5,15,6,0
1020,5,3,1,2,2,5,8,62.5,3,5,1,4,3,8,22,0
1021,15,7,8,3,4,5,17,29.4,12,5,0,5,6,21,6,0
1022,19,11,9,5,5,9,35,25.7,26,15,2,13,7,26,12,2
1023,33,24,29,3,1,18,27,66.7,9,33,23,10,40,73,125,2
1024,1,0,1,0,0,1,2,50,1,0,0,0,1,2,8,2
1025,43,28,17,22,4,14,39,35.9,25,33,10,23,18,61,29,0
1026,2,1,0,2,0,1,1,100,0,0,0,0,1,3,0,0
1027,5,2,2,2,1,2,5,40,3,2,0,2,3,8,2,0
1028,1,1,1,0,0,1,1,100,0,0,0,0,1,2,9,0
1029,25,16,18,7,0,9,16,56.3,7,21,13,8,19,44,87,0
1030,25,19,15,8,2,17,24,70.8,7,17,11,6,23,48,82,0
1031,9,3,4,4,1,3,5,60,2,7,2,5,4,13,14,0
1032,21,16,6,8,7,9,28,32.1,19,26,2,24,21,42,4,1
1033,31,20,5,23,3,11,27,40.7,16,12,0,12,6,37,12,0
1034,0,0,0,0,0,0,0,,0,0,0,0,1,1,0,0
1035,5,4,3,2,0,4,6,66.7,2,5,0,5,1,6,1,0
1036,7,5,5,2,0,4,4,100,0,4,2,2,2,9,8,0
1037,54,32,20,30,4,21,59,35.6,38,49,3,46,22,76,17,0
1038,1,0,0,0,1,0,0,,0,0,0,0,0,1,0,0
1039,25,15,12,9,4,11,26,42.3,15,11,1,10,17,42,23,2
1040,0,0,0,0,0,0,0,,0,2,0,2,0,0,0,0
1041,47,31,32,9,6,25,47,53.2,22,16,3,13,18,65,49,0
1042,7,3,3,4,0,4,8,50,4,4,0,4,9,16,1,0
1043,3,1,1,2,0,0,0,,0,5,2,3,3,6,3,0
1044,2,1,1,1,0,2,6,33.3,4,2,0,2,0,2,3,0
1045,22,13,2,13,7,10,32,31.3,22,22,5,17,11,33,17,1
1046,45,26,22,18,5,21,36,58.3,15,22,3,19,13,58,9,2
1047,50,27,33,17,0,22,36,61.1,14,35,18,17,49,99,116,0
1048,60,28,24,28,8,25,45,55.6,20,39,27,12,65,125,106,0
1049,0,0,0,0,0,0,0,,0,0,0,0,0,0,1,0
1050,47,26,13,30,4,16,38,42.1,22,27,9,18,63,110,33,1
1051,1,1,1,0,0,0,1,0,1,0,0,0,0,1,0,0
1052,32,24,19,13,0,17,27,63,10,25,15,10,33,65,83,1
1053,30,19,13,10,7,10,22,45.5,12,30,2,28,15,45,21,1
1054,2,1,0,2,0,2,6,33.3,4,3,1,2,0,2,7,0
1055,0,0,0,0,0,0,0,,0,0,0,0,0,0,14,1
1056,18,17,4,10,4,5,13,38.5,8,11,1,10,8,26,7,0
1057,1,1,1,0,0,0,0,,0,0,0,0,1,2,9,0
1058,9,5,0,8,1,2,8,25,6,10,2,8,7,16,10,0
1059,15,9,9,1,5,3,9,33.3,6,5,0,5,1,16,6,0
1060,8,5,0,5,3,4,7,57.1,3,3,0,3,2,10,1,0
1061,19,8,4,10,5,2,15,13.3,13,18,2,16,6,25,29,0
1062,0,0,0,0,0,0,0,,0,0,0,0,0,0,0,0
1063,0,0,0,0,0,0,0,,0,1,1,0,0,0,1,0
1064,60,31,38,19,3,39,62,62.9,23,38,13,25,43,103,100,1
1065,1,1,0,1,0,1,1,100,0,0,0,0,0,1,0,0
1066,13,5,3,10,0,2,6,33.3,4,4,0,4,3,16,5,0
1067,30,14,11,15,4,12,32,37.5,20,18,1,17,7,37,18,0
1068,27,15,9,13,5,9,26,34.6,17,12,2,10,13,40,28,0
1069,0,0,0,0,0,0,0,,0,0,0,0,0,0,0,0
1070,37,19,15,21,1,17,31,54.8,14,18,7,11,29,66,36,1
1071,28,15,15,11,2,12,33,36.4,21,34,8,26,18,46,23,0
1072,22,11,10,10,2,8,21,38.1,13,11,2,9,9,31,15,0
1073,1,0,1,0,0,1,1,100,0,0,0,0,1,2,8,1
1074,30,13,12,17,1,13,34,38.2,21,18,4,14,21,51,29,1
1075,10,9,3,5,2,1,21,4.8,20,14,2,12,4,14,17,0
1076,16,7,10,4,2,5,8,62.5,3,14,9,5,22,38,37,0
1077,43,31,24,16,3,17,35,48.6,18,15,3,12,20,63,13,0
1078,0,0,0,0,0,0,0,,0,0,0,0,0,0,0,0
1079,21,14,6,7,8,2,22,9.1,20,14,0,14,9,30,1,0
1080,35,17,24,10,1,15,16,93.8,1,34,26,8,30,65,127,0
1081,45,30,10,26,9,13,47,27.7,34,15,1,14,16,61,18,0
1082,2,1,0,1,1,1,1,100,0,0,0,0,0,2,0,0
1083,35,19,19,12,4,16,31,51.6,15,18,2,16,25,60,14,1
1084,9,8,2,5,2,3,8,37.5,5,4,0,4,0,9,1,0
1085,18,13,6,10,2,10,17,58.8,7,12,6,6,12,30,8,0
1086,5,5,1,1,3,3,7,42.9,4,4,0,4,6,11,1,0
1087,38,19,15,22,1,16,31,51.6,15,15,3,12,24,62,16,0
1088,2,1,0,0,2,0,1,0,1,1,0,1,0,2,0,0
1089,39,16,18,17,4,14,29,48.3,15,16,8,8,36,75,23,0
1090,23,14,13,9,1,7,18,38.9,11,11,6,5,25,48,42,0
1091,69,39,33,24,12,32,62,51.6,30,37,11,26,55,124,39,0
1092,43,27,20,16,7,18,44,40.9,26,26,10,16,30,73,53,1
1093,44,23,18,22,4,21,38,55.3,17,25,6,19,9,53,13,0
1094,50,31,20,25,5,23,59,39,36,21,4,17,21,71,11,1
1095,4,2,1,2,1,1,7,14.3,6,4,0,4,1,5,8,0
1096,0,0,0,0,0,0,0,,0,0,0,0,1,1,15,1
1097,18,10,14,3,1,8,11,72.7,3,16,8,8,17,35,37,0
1098,46,19,22,19,5,22,51,43.1,29,18,4,14,23,69,25,0
1099,48,29,25,20,3,25,43,58.1,18,24,7,17,28,76,57,3
1100,23,9,10,12,1,12,31,38.7,19,11,1,10,15,38,10,0
1101,0,0,0,0,0,0,0,,0,0,0,0,0,0,11,0
1102,34,20,16,15,3,18,50,36,32,23,6,17,17,51,49,2
1103,32,18,19,11,2,16,32,50,16,27,21,6,69,101,110,1
1104,8,5,4,3,1,5,9,55.6,4,0,0,0,2,10,2,0
1105,5,3,2,3,0,1,4,25,3,3,1,2,3,8,4,0
1106,55,35,29,21,5,24,40,60,16,21,6,15,33,88,41,1
1107,25,15,7,14,4,10,30,33.3,20,9,3,6,25,50,7,0
1108,1,0,0,1,0,0,2,0,2,2,1,1,1,2,9,0
1109,7,5,5,0,2,3,5,60,2,0,0,0,2,9,2,0
1110,5,3,2,1,2,3,8,37.5,5,2,0,2,5,10,4,0
1111,47,31,28,17,2,22,39,56.4,17,30,11,19,51,98,62,2
1112,47,30,31,9,7,21,41,51.2,20,22,4,18,16,63,43,1
1113,53,32,40,11,2,33,50,66,17,38,24,14,44,97,126,1
1114,2,1,0,1,1,0,1,0,1,8,1,7,1,3,31,0
1115,35,22,15,10,10,17,39,43.6,22,24,4,20,9,44,17,1
1116,14,8,5,6,3,7,19,36.8,12,11,4,7,16,30,11,0
1117,52,26,35,17,0,29,46,63,17,31,14,17,51,103,95,1
1118,14,8,6,5,3,3,21,14.3,18,18,1,17,5,19,4,0
1119,8,4,1,6,1,2,8,25,6,7,1,6,5,13,2,0
1120,36,20,9,15,12,17,50,34,33,38,5,33,15,51,43,0
1121,30,14,11,19,0,17,37,45.9,20,22,6,16,16,46,8,1
1122,28,21,18,7,3,15,24,62.5,9,18,4,14,22,50,31,0
1123,22,11,12,6,4,15,23,65.2,8,12,6,6,22,44,28,0
1124,74,51,38,27,9,40,72,55.6,32,26,5,21,28,102,23,2
1125,10,7,6,4,0,6,11,54.5,5,6,0,6,7,17,11,0
1126,0,0,0,0,0,0,1,0,1,0,0,0,2,2,0,0
1127,11,6,0,5,6,5,6,83.3,1,2,1,1,0,11,0,0
1128,10,7,1,5,4,2,13,15.4,11,8,0,8,4,14,1,0
1129,1,0,1,0,0,1,2,50,1,1,0,1,0,1,6,3
1130,44,25,28,14,2,18,35,51.4,17,56,45,11,56,100,176,2
1131,36,20,26,4,6,11,21,52.4,10,34,12,22,29,65,57,1
1132,37,20,12,22,3,15,48,31.3,33,25,3,22,26,63,15,0
1133,18,11,9,9,0,9,17,52.9,8,10,0,10,4,22,2,0
1134,31,21,20,10,1,19,29,65.5,10,22,12,10,15,46,62,0
1135,57,37,22,22,13,31,76,40.8,45,35,1,34,21,78,19,0
1136,11,4,4,7,0,8,11,72.7,3,14,0,14,4,15,5,0
1137,0,0,0,0,0,0,0,,0,0,0,0,0,0,0,0
1138,27,12,15,11,1,13,29,44.8,16,24,8,16,22,49,36,0
1139,22,14,10,8,4,11,26,42.3,15,11,1,10,7,29,20,0
1140,3,3,2,0,1,3,4,75,1,8,5,3,6,9,13,0
1141,17,8,5,7,5,4,14,28.6,10,28,1,27,4,21,32,1
1142,28,14,11,14,3,12,29,41.4,17,17,8,9,14,42,24,0
1143,6,3,3,2,1,3,7,42.9,4,3,0,3,2,8,0,0
1144,23,13,8,10,5,15,40,37.5,25,23,1,22,6,29,4,0
1145,76,39,36,26,14,29,74,39.2,45,59,8,51,50,126,68,1
1146,27,13,9,16,2,14,44,31.8,30,10,0,10,13,40,7,1
1147,0,0,0,0,0,0,0,,0,0,0,0,1,1,0,0
1148,50,30,23,22,5,32,58,55.2,26,20,4,16,20,70,34,1
1149,8,5,5,3,0,3,6,50,3,7,4,3,7,15,14,0
1150,0,0,0,0,0,0,0,,0,0,0,0,1,1,0,0
1151,36,20,9,25,2,17,44,38.6,27,25,1,24,23,59,14,0
1152,22,13,7,8,7,9,31,29,22,14,4,10,9,31,13,0
1153,1,1,0,1,0,1,1,100,0,0,0,0,0,1,1,0
1154,0,0,0,0,0,0,0,,0,0,0,0,1,1,0,1
1155,30,21,18,6,6,12,22,54.5,10,16,1,15,19,49,14,0
1156,13,7,10,1,2,5,16,31.3,11,13,1,12,22,35,14,0
1157,43,23,23,16,4,11,35,31.4,24,28,5,23,24,67,34,0
1158,4,3,2,1,1,2,5,40,3,2,0,2,5,9,1,0
1159,10,3,6,3,1,6,24,25,18,14,2,12,7,17,12,1
1160,28,20,18,8,2,12,34,35.3,22,31,10,21,26,54,76,1
1161,9,4,2,3,4,5,13,38.5,8,11,5,6,2,11,25,0
1162,48,28,30,16,2,17,26,65.4,9,20,15,5,44,92,84,1
1163,3,1,1,2,0,2,5,40,3,4,1,3,4,7,7,0
1164,2,1,2,0,0,2,2,100,0,2,1,1,0,2,5,1
1165,30,15,23,4,3,20,38,52.6,18,18,3,15,29,59,49,2
1166,12,9,10,2,0,3,13,23.1,10,11,9,2,20,32,71,0
1167,50,31,20,24,6,26,42,61.9,16,22,11,11,28,78,54,1
1168,9,5,9,0,0,5,8,62.5,3,5,3,2,16,25,34,0
1169,10,4,7,3,0,5,9,55.6,4,1,0,1,4,14,7,0
1170,53,35,34,14,5,29,40,72.5,11,16,3,13,23,76,29,3
1171,20,10,8,9,3,13,32,40.6,19,17,4,13,13,33,5,1
1172,29,17,7,16,6,14,39,35.9,25,22,8,14,14,43,8,0
1173,16,8,11,4,1,7,20,35,13,13,2,11,12,28,16,0
1174,3,2,3,0,0,3,6,50,3,1,0,1,1,4,18,0
1175,41,31,19,19,3,18,39,46.2,21,27,5,22,19,60,33,1
1176,15,7,5,6,4,9,24,37.5,15,10,1,9,6,21,8,0
1177,15,6,5,7,3,5,23,21.7,18,27,6,21,13,28,8,0
1178,3,1,1,2,0,1,5,20,4,7,3,4,4,7,3,0
1179,46,29,24,15,7,20,30,66.7,10,36,13,23,29,75,44,0
1180,33,23,23,8,2,19,25,76,6,34,15,19,33,66,56,2
1181,45,28,28,16,1,28,43,65.1,15,36,16,20,42,87,78,3
1182,0,0,0,0,0,0,0,,0,0,0,0,0,0,2,0
1183,10,6,5,5,0,7,12,58.3,5,6,0,6,6,16,8,0
1184,73,42,37,29,7,28,62,45.2,34,50,21,29,46,119,42,0
1185,30,20,6,17,7,17,42,40.5,25,23,0,23,12,42,10,0
1186,13,9,11,1,1,5,6,83.3,1,23,18,5,10,23,42,1
1187,41,25,10,17,14,13,28,46.4,15,25,4,21,17,58,39,2
1188,35,18,26,9,0,11,26,42.3,15,25,17,8,26,61,95,1
1189,15,9,5,3,7,6,22,27.3,16,26,2,24,8,23,6,0
1190,14,8,5,6,3,4,8,50,4,6,2,4,4,18,16,1
1191,54,38,25,13,16,27,47,57.4,20,24,2,22,15,69,25,0
1192,6,5,4,2,0,4,6,66.7,2,5,5,0,4,10,4,0
1193,0,0,0,0,0,0,1,0,1,1,0,1,0,0,0,0
1194,1,0,0,0,1,0,3,0,3,0,0,0,0,1,0,0
1195,6,4,4,2,0,4,8,50,4,1,1,0,3,9,9,0
1196,0,0,0,0,0,0,1,0,1,0,0,0,0,0,5,0
1197,3,1,1,2,0,0,2,0,2,3,0,3,4,7,5,0
1198,33,17,20,12,1,16,24,66.7,8,23,12,11,34,67,76,0
1199,1,1,1,0,0,1,1,100,0,0,0,0,0,1,10,1
1200,46,29,10,31,5,21,72,29.2,51,27,1,26,11,57,3,1
1201,17,10,11,6,0,10,16,62.5,6,29,23,6,19,36,47,0
1202,16,11,5,7,4,11,32,34.4,21,18,1,17,10,26,7,0
1203,45,27,28,17,0,27,45,60,18,31,19,12,52,97,95,0
1204,9,5,0,7,2,3,5,60,2,2,2,0,9,18,7,0
1205,14,10,5,6,3,8,23,34.8,15,8,0,8,2,16,6,1
1206,29,14,10,16,3,7,16,43.8,9,13,7,6,8,37,10,0
1207,34,22,20,13,1,20,36,55.6,16,18,13,5,32,66,66,1
1208,46,30,25,17,4,29,45,64.4,16,18,6,12,24,70,34,1
1209,0,0,0,0,0,0,0,,0,2,0,2,0,0,2,0
1210,78,45,31,38,9,38,85,44.7,47,61,13,48,48,126,54,0
1211,49,29,25,19,5,15,34,44.1,19,28,6,22,27,76,62,0
1212,3,3,2,0,1,1,2,50,1,1,0,1,1,4,1,0
1213,54,32,31,19,4,26,43,60.5,17,26,7,19,62,116,104,2
1214,19,10,9,7,3,12,24,50,12,11,5,6,11,30,27,1
1215,0,0,0,0,0,0,2,0,2,2,1,1,3,3,9,0
1216,5,3,1,3,1,3,7,42.9,4,3,0,3,5,10,12,0
1217,9,6,2,5,2,2,3,66.7,1,4,2,2,3,12,7,0
1218,1,0,0,1,0,0,1,0,1,1,0,1,1,2,1,0
1219,8,4,3,4,1,4,15,26.7,11,8,0,8,3,11,5,0
1220,19,10,11,8,0,7,17,41.2,10,8,2,6,10,29,28,0
1221,6,4,1,2,3,0,8,0,8,11,1,10,4,10,7,0
1222,18,11,6,10,2,10,18,55.6,8,8,2,6,5,23,2,1
1223,2,1,0,1,1,0,0,,0,0,0,0,0,2,0,0
1224,53,31,34,16,3,30,40,75,10,37,19,18,31,84,46,4
1225,10,7,2,5,3,3,14,21.4,11,19,0,19,4,14,10,0
1226,17,9,8,7,2,10,24,41.7,14,9,2,7,6,23,17,1
1227,7,3,2,3,2,3,10,30,7,10,2,8,1,8,2,0
1228,11,3,6,4,1,4,11,36.4,7,13,1,12,5,16,4,0
1229,39,18,16,19,4,20,54,37,34,34,12,22,22,61,55,0
1230,7,7,3,2,2,4,17,23.5,13,6,1,5,3,10,1,0
1231,9,5,5,3,1,1,10,10,9,5,1,4,4,13,12,0
1232,14,8,7,6,1,5,10,50,5,6,2,4,6,20,15,1
1233,10,5,4,4,2,1,15,6.7,14,7,1,6,3,13,16,0
1234,1,1,1,0,0,1,2,50,1,1,0,1,0,1,0,0
1235,23,16,2,16,5,13,37,35.1,24,31,2,29,6,29,22,0
1236,0,0,0,0,0,0,2,0,2,0,0,0,2,2,1,0
1237,3,2,2,0,1,3,9,33.3,6,6,0,6,6,9,7,1
1238,27,16,10,16,1,11,26,42.3,15,11,3,8,16,43,14,0
1239,23,14,8,12,3,8,44,18.2,36,30,1,29,20,43,3,1
1240,0,0,0,0,0,0,0,,0,0,0,0,0,0,0,0
1241,5,4,2,3,0,1,1,100,0,0,0,0,2,7,1,0
1242,7,4,1,3,3,2,12,16.7,10,14,2,12,3,10,10,0
1243,9,5,4,4,1,5,12,41.7,7,1,0,1,2,11,1,0
1244,0,0,0,0,0,0,4,0,4,1,0,1,0,0,0,0
1245,13,9,8,4,1,5,14,35.7,9,21,11,10,24,37,80,0
1246,43,31,21,19,3,25,43,58.1,18,40,19,21,53,96,95,0
1247,5,2,1,2,2,1,6,16.7,5,3,0,3,2,7,4,0
1248,44,26,30,11,3,21,38,55.3,17,24,9,15,13,57,51,0
1249,40,19,23,12,5,21,52,40.4,31,39,3,36,20,60,25,2
1250,16,9,14,2,0,9,11,81.8,2,5,4,1,17,33,21,0
1251,2,0,1,0,1,0,0,,0,0,0,0,1,3,1,0
1252,30,12,8,14,8,6,27,22.2,21,20,2,18,18,48,18,0
1253,51,29,27,24,0,29,51,56.9,22,34,10,24,57,108,81,0
1254,24,14,14,7,3,11,23,47.8,12,7,0,7,11,35,5,0
1255,37,22,10,21,6,15,62,24.2,47,33,3,30,21,58,25,1
1256,32,16,14,15,3,16,35,45.7,19,16,1,15,17,49,31,0
1257,2,1,0,1,1,0,6,0,6,0,0,0,1,3,0,0
1258,9,5,5,3,1,3,4,75,1,8,4,4,12,21,34,0
1259,2,1,0,2,0,0,0,,0,2,0,2,0,2,1,0
1260,24,14,8,8,8,10,23,43.5,13,18,1,17,8,32,12,0
1261,33,25,14,18,1,9,22,40.9,13,20,2,18,17,50,22,0
1262,61,32,26,27,8,27,53,50.9,26,23,7,16,28,89,35,0
1263,11,7,5,5,1,10,17,58.8,7,4,0,4,4,15,7,0
1264,40,21,32,8,0,22,34,64.7,12,37,27,10,52,92,187,0
1265,6,5,2,4,0,3,6,50,3,3,2,1,5,11,8,0
1266,17,11,5,8,4,9,24,37.5,15,15,3,12,12,29,15,0
1267,10,5,7,3,0,5,7,71.4,2,4,0,4,10,20,19,0
1268,11,7,6,4,1,7,20,35,13,7,0,7,7,18,5,0
1269,4,1,2,1,1,0,1,0,1,2,0,2,1,5,1,0
1270,2,1,1,1,0,2,8,25,6,1,0,1,5,7,3,0
1271,26,14,9,9,8,8,27,29.6,19,25,3,22,6,32,23,0
1272,9,6,4,4,1,3,6,50,3,5,0,5,1,10,0,0
1273,37,25,30,7,0,18,26,69.2,8,23,8,15,25,62,33,1
1274,5,4,1,3,1,4,7,57.1,3,5,1,4,2,7,4,0
1275,33,18,12,16,5,22,63,34.9,41,32,3,29,22,55,13,0
1276,26,12,18,6,2,11,24,45.8,13,19,11,8,28,54,55,0
1277,18,12,2,4,12,6,26,23.1,20,18,0,18,15,33,8,0
1278,25,17,14,11,0,12,18,66.7,6,21,16,5,9,34,34,0
1279,6,3,3,2,1,4,7,57.1,3,3,0,3,3,9,0,0
1280,29,14,6,16,7,6,30,20,24,31,5,26,13,42,26,0
1281,20,14,7,8,5,6,23,26.1,17,23,3,20,15,35,17,0
1282,6,2,4,2,0,3,8,37.5,5,5,2,3,3,9,10,0
1283,72,38,30,33,9,26,61,42.6,35,46,11,35,34,106,50,2
1284,1,1,0,0,1,1,1,100,0,0,0,0,0,1,0,0
1285,0,0,0,0,0,0,1,0,1,1,0,1,1,1,1,0
1286,14,10,8,4,2,6,18,33.3,12,14,1,13,5,19,3,0
1287,33,16,15,15,3,21,28,75,7,16,8,8,22,55,55,0
1288,11,9,3,6,2,1,10,10,9,4,0,4,6,17,4,0
1289,5,5,3,1,1,2,3,66.7,1,4,4,0,3,8,8,0
1290,35,19,12,18,5,12,23,52.2,11,19,5,14,20,55,16,0
1291,9,7,1,5,3,1,2,50,1,4,0,4,0,9,12,0
1292,61,30,22,31,8,28,65,43.1,37,27,6,21,30,91,18,1
1293,2,1,0,2,0,1,3,33.3,2,1,0,1,0,2,2,0
1294,64,33,27,31,6,29,83,34.9,54,27,4,23,36,100,21,1
1295,36,22,23,9,4,26,44,59.1,18,11,4,7,10,46,21,0
1296,15,13,2,10,3,2,8,25,6,10,2,8,3,18,16,0
1297,16,11,1,9,6,7,25,28,18,21,4,17,7,23,45,0
1298,3,2,1,1,1,0,2,0,2,1,1,0,0,3,11,0
1299,2,1,1,1,0,0,0,,0,3,0,3,0,2,0,0
1300,39,18,12,18,9,13,55,23.6,42,19,2,17,6,45,6,0
1301,5,2,0,2,3,1,6,16.7,5,3,0,3,1,6,6,0
1302,1,1,0,1,0,0,1,0,1,3,0,3,1,2,4,0
1303,2,2,1,1,0,0,0,,0,1,0,1,0,2,5,0
1304,1,0,0,0,1,0,1,0,1,1,0,1,1,2,0,0
1305,39,25,11,19,9,19,49,38.8,30,24,1,23,9,48,10,1
1306,3,1,1,2,0,2,4,50,2,1,1,0,2,5,5,0
1307,2,2,1,0,1,0,2,0,2,0,0,0,0,2,0,0
1308,3,2,3,0,0,3,5,60,2,0,0,0,2,5,2,0
1309,32,18,8,14,10,10,46,21.7,36,22,2,20,12,44,6,1
1310,46,24,23,19,4,15,50,30,35,25,0,25,6,52,6,0
1311,22,13,11,8,3,7,15,46.7,8,16,4,12,17,39,34,0
1312,2,1,0,1,1,0,1,0,1,2,0,2,1,3,1,0
1313,40,29,22,17,1,17,35,48.6,18,17,7,10,34,74,32,0
1314,10,4,3,5,2,7,10,70,3,6,1,5,10,20,13,0
1315,10,5,4,6,0,5,9,55.6,4,19,11,8,16,26,26,0
1316,11,5,10,1,0,7,10,70,3,20,16,4,14,25,67,1
1317,45,22,22,14,9,20,38,52.6,18,27,2,25,20,65,38,1
1318,4,2,3,1,0,2,8,25,6,3,0,3,3,7,1,0
1319,11,10,6,3,2,5,16,31.3,11,18,6,12,13,24,22,0
1320,7,5,2,2,3,4,13,30.8,9,7,0,7,4,11,1,1
1321,41,26,9,25,7,23,51,45.1,28,27,3,24,32,73,24,0
1322,22,14,2,13,7,4,20,20,16,10,0,10,4,26,3,0
1323,10,6,2,5,3,3,11,27.3,8,5,0,5,2,12,14,0
1324,0,0,0,0,0,0,0,,0,0,0,0,0,0,0,0
1325,9,8,1,3,5,2,7,28.6,5,6,1,5,8,17,0,0
1326,2,0,0,1,1,1,2,50,1,2,0,2,0,2,2,0
1327,15,11,5,6,4,3,11,27.3,8,7,1,6,1,16,5,0
1328,2,2,0,2,0,1,1,100,0,2,0,2,3,5,3,0
1329,8,5,3,4,1,2,5,40,3,2,0,2,3,11,1,0
1330,61,36,36,21,4,17,22,77.3,5,36,15,21,26,87,54,0
1331,40,21,7,26,7,11,40,27.5,29,18,0,18,8,48,10,0
1332,68,38,27,36,5,26,47,55.3,21,29,10,19,46,114,44,1
1333,53,34,31,16,6,27,43,62.8,16,20,4,16,69,122,67,0
1334,13,10,4,6,3,5,8,62.5,3,10,2,8,9,22,4,0
1335,1,1,1,0,0,1,1,100,0,0,0,0,2,3,1,0
1336,41,19,16,20,5,10,42,23.8,32,24,5,19,24,65,17,0
1337,10,6,8,2,0,4,9,44.4,5,11,4,7,16,26,22,1
1338,2,1,2,0,0,1,1,100,0,1,1,0,0,2,0,0
1339,15,5,2,10,3,7,18,38.9,11,26,8,18,3,18,39,0
1340,13,6,2,9,2,5,29,17.2,24,11,1,10,5,18,7,0
1341,59,31,20,27,12,25,40,62.5,15,37,2,35,31,90,8,0
1342,0,0,0,0,0,0,0,,0,0,0,0,0,0,0,0
1343,48,24,18,27,3,18,36,50,18,37,14,23,34,82,47,0
1344,53,38,33,13,7,28,50,56,22,22,5,17,34,87,26,1
1345,9,7,5,3,1,2,5,40,3,4,0,4,3,12,4,0
1346,30,19,9,19,2,7,23,30.4,16,21,5,16,22,52,8,0
1347,5,4,4,0,1,3,7,42.9,4,5,0,5,2,7,1,0
1348,1,1,1,0,0,1,1,100,0,0,0,0,0,1,1,0
1349,0,0,0,0,0,0,0,,0,0,0,0,0,0,0,0
1350,21,13,11,9,1,8,16,50,8,6,1,5,9,30,13,0
1351,0,0,0,0,0,0,0,,0,0,0,0,0,0,0,0
1352,9,4,2,5,2,6,16,37.5,10,5,0,5,3,12,8,1
1353,46,25,32,13,1,28,45,62.2,17,33,28,5,62,108,128,2
1354,31,15,13,10,8,12,44,27.3,32,16,0,16,13,44,3,0
1355,9,6,6,3,0,8,13,61.5,5,10,2,8,8,17,15,0
1356,21,14,9,11,1,9,21,42.9,12,19,11,8,24,45,29,0
1357,0,0,0,0,0,0,0,,0,0,0,0,0,0,0,0
1358,46,23,17,19,10,26,42,61.9,16,33,2,31,14,60,8,0
1359,11,4,5,4,2,5,15,33.3,10,7,1,6,1,12,8,0
1360,1,1,1,0,0,1,1,100,0,0,0,0,0,1,1,0
1361,10,9,9,1,0,5,14,35.7,9,14,7,7,25,35,49,1
1362,13,8,7,4,2,3,10,30,7,16,14,2,16,29,26,2
1363,5,2,1,2,2,2,3,66.7,1,0,0,0,0,5,0,0
1364,17,7,11,6,0,13,21,61.9,8,8,1,7,20,37,31,0
1365,0,0,0,0,0,0,0,,0,0,0,0,0,0,0,0
1366,41,23,12,24,5,17,26,65.4,9,39,10,29,23,64,22,0
1367,19,10,5,10,4,9,18,50,9,9,0,9,14,33,5,0
1368,33,18,7,17,9,9,34,26.5,25,21,0,21,12,45,7,0
1369,75,38,25,42,8,32,66,48.5,34,21,8,13,50,125,27,1
1370,11,7,3,4,4,3,23,13,20,10,1,9,3,14,12,0
1371,0,0,0,0,0,0,0,,0,0,0,0,0,0,0,0
1372,42,24,30,9,3,21,41,51.2,20,31,13,18,46,88,109,3
1373,50,26,38,10,2,24,37,64.9,13,36,21,15,45,95,113,3
1374,39,20,14,17,8,18,58,31,40,34,8,26,52,91,29,1
1375,34,19,18,15,1,14,23,60.9,9,20,14,6,38,72,73,1
1376,19,15,7,6,6,4,17,23.5,13,15,4,11,8,27,31,0
1377,50,27,25,19,6,26,57,45.6,31,38,15,23,40,90,53,0
1378,24,14,9,11,4,12,32,37.5,20,15,1,14,10,34,9,0
1379,20,12,9,8,3,6,12,50,6,17,13,4,9,29,39,0
1380,0,0,0,0,0,0,0,,0,0,0,0,0,0,0,0
1381,7,3,1,4,2,3,3,100,0,6,1,5,1,8,0,0
1382,47,25,18,23,6,25,66,37.9,41,22,4,18,11,58,20,0
1383,0,0,0,0,0,0,1,0,1,1,1,0,2,2,0,0
1384,13,6,6,7,0,5,16,31.3,11,2,0,2,4,17,3,0
1385,7,5,0,5,2,2,10,20,8,17,4,13,0,7,31,0
1386,29,16,11,15,3,13,19,68.4,6,16,3,13,26,55,58,0
1387,19,9,6,12,1,5,21,23.8,16,13,1,12,14,33,6,0
1388,1,1,1,0,0,1,5,20,4,1,0,1,2,3,2,0
1389,3,1,1,1,1,0,4,0,4,2,0,2,0,3,4,0
1390,18,14,8,5,5,8,15,53.3,7,11,1,10,8,26,6,0
1391,50,24,38,12,0,30,53,56.6,23,45,26,19,49,99,151,1
1392,0,0,0,0,0,0,2,0,2,0,0,0,1,1,20,0
1393,21,13,9,10,2,9,34,26.5,25,26,10,16,20,41,44,0
1394,0,0,0,0,0,0,0,,0,0,0,0,0,0,0,0
1395,4,0,0,3,1,0,2,0,2,2,1,1,3,7,3,0
1396,40,20,18,19,3,16,42,38.1,26,21,2,19,35,75,22,0
1397,4,3,2,1,1,2,6,33.3,4,3,0,3,4,8,5,0
1398,55,30,19,29,7,26,63,41.3,37,21,5,16,24,79,31,1
1399,1,1,1,0,0,0,0,,0,1,0,1,0,1,0,0
1400,1,1,1,0,0,1,1,100,0,0,0,0,1,2,2,0
1401,0,0,0,0,0,0,0,,0,0,0,0,4,4,1,0
1402,7,6,2,3,2,5,8,62.5,3,4,0,4,0,7,7,1
1403,0,0,0,0,0,0,0,,0,0,0,0,0,0,0,0
1404,28,14,7,10,11,10,25,40,15,14,3,11,6,34,31,0
1405,43,24,22,14,7,20,36,55.6,16,29,7,22,60,103,72,1
1406,35,19,19,15,1,16,30,53.3,14,35,8,27,28,63,45,0
1407,16,10,9,6,1,7,10,70,3,13,9,4,16,32,37,1
1408,74,44,25,40,9,21,49,42.9,28,16,5,11,44,118,24,0
1409,7,4,0,3,4,2,3,66.7,1,8,3,5,1,8,3,0
1410,60,37,29,28,3,25,42,59.5,17,27,4,23,34,94,12,0
1411,30,18,21,8,1,19,30,63.3,11,8,3,5,10,40,25,0
1412,25,15,13,11,1,10,13,76.9,3,31,22,9,15,40,86,2
1413,40,24,10,19,11,22,54,40.7,32,31,2,29,15,55,19,0
1414,14,9,10,3,1,8,13,61.5,5,17,12,5,12,26,39,0
1415,23,17,16,6,1,15,25,60,10,36,14,22,26,49,66,0
1416,44,17,26,9,9,20,53,37.7,33,24,1,23,15,59,24,0
1417,47,22,24,20,3,19,58,32.8,39,33,5,28,46,93,22,2
1418,39,23,31,6,2,25,38,65.8,13,41,25,16,29,68,90,1
1419,40,17,27,10,3,18,28,64.3,10,33,18,15,21,61,101,2
1420,0,0,0,0,0,0,1,0,1,1,0,1,0,0,0,0
1421,84,50,56,28,0,48,77,62.3,29,63,33,30,79,163,217,3
1422,52,38,28,22,2,18,39,46.2,21,40,14,26,38,90,39,0
1423,51,31,14,26,11,17,35,48.6,18,19,4,15,7,58,9,1
1424,16,10,7,8,1,9,21,42.9,12,16,3,13,13,29,8,0
1425,37,16,25,11,1,27,36,75,9,16,10,6,25,62,56,0
1426,0,0,0,0,0,0,0,,0,0,0,0,0,0,0,0
1427,8,4,1,5,2,7,17,41.2,10,10,0,10,9,17,7,1
1428,28,11,15,10,3,12,28,42.9,16,18,5,13,12,40,9,0
1429,7,5,0,5,2,2,10,20,8,7,1,6,0,7,1,0
1430,0,0,0,0,0,0,0,,0,0,0,0,0,0,0,0
1431,34,26,13,17,4,14,36,38.9,22,16,3,13,12,46,13,1
1432,3,1,0,3,0,2,10,20,8,12,1,11,2,5,13,0
1433,1,1,1,0,0,1,4,25,3,0,0,0,0,1,10,4
1434,33,18,16,14,3,15,31,48.4,16,19,2,17,16,49,17,0
1435,9,3,4,4,1,5,12,41.7,7,2,0,2,3,12,4,0
1436,4,1,0,3,1,2,16,12.5,14,12,0,12,3,7,2,0
1437,62,35,38,16,8,28,49,57.1,21,24,8,16,44,106,70,0
1438,31,19,12,14,5,10,24,41.7,14,24,3,21,8,39,4,0
1439,59,39,32,25,2,27,73,37,46,30,9,21,27,86,46,2
1440,0,0,0,0,0,0,0,,0,0,0,0,0,0,0,0
1441,19,13,7,10,2,5,23,21.7,18,14,0,14,13,32,3,0
1442,15,12,9,6,0,8,21,38.1,13,14,0,14,5,20,5,0
1443,21,13,13,7,1,8,15,53.3,7,17,8,9,16,37,26,0
1444,35,21,14,20,1,15,32,46.9,17,17,2,15,19,54,27,1
1445,54,35,31,19,4,33,72,45.8,39,17,4,13,43,97,48,1
1446,3,2,1,1,1,0,6,0,6,6,0,6,0,3,1,0
1447,30,14,19,7,4,19,38,50,19,32,9,23,11,41,52,0
1448,2,0,0,0,2,1,2,50,1,3,1,2,1,3,6,0
1449,2,2,1,1,0,2,4,50,2,3,0,3,5,7,5,0
1450,19,7,5,8,6,3,22,13.6,19,29,3,26,8,27,16,0
1451,27,10,8,13,6,7,21,33.3,14,12,1,11,5,32,6,0
1452,18,13,11,5,2,9,24,37.5,15,14,4,10,9,27,20,1
1453,9,7,8,1,0,5,8,62.5,3,5,1,4,10,19,5,0
1454,59,33,41,16,2,29,40,72.5,11,35,16,19,60,119,144,0
1455,3,3,3,0,0,3,8,37.5,5,1,0,1,1,4,25,2
1456,29,16,21,8,0,19,30,63.3,11,36,24,12,27,56,151,1
1457,38,24,11,22,5,24,53,45.3,29,29,3,26,4,42,9,0
1458,19,11,9,7,3,12,28,42.9,16,24,5,19,14,33,31,0
1459,1,1,0,1,0,0,3,0,3,3,0,3,1,2,0,0
1460,34,17,14,14,6,12,41,29.3,29,16,6,10,16,50,13,1
1461,18,12,13,3,2,11,25,44,14,21,10,11,17,35,56,0
1462,31,18,12,14,5,10,29,34.5,19,11,0,11,5,36,3,0
1463,12,5,4,3,5,3,24,12.5,21,7,1,6,7,19,14,0
1464,3,1,1,0,2,1,3,33.3,2,3,1,2,1,4,7,0
1465,1,0,0,0,1,0,0,,0,0,0,0,0,1,0,0
1466,4,4,0,2,2,2,6,33.3,4,9,2,7,2,6,4,0
1467,36,25,14,17,5,15,25,60,10,13,3,10,21,57,23,0
1468,28,15,10,11,7,10,35,28.6,25,16,0,16,19,47,10,0
1469,33,15,22,10,1,14,20,70,6,15,10,5,20,53,64,2
1470,63,45,35,26,2,32,64,50,32,37,22,15,54,117,174,0
1471,6,5,2,4,0,3,3,100,0,1,0,1,7,13,5,0
1472,13,7,4,5,4,4,15,26.7,11,16,0,16,3,16,7,0
1473,15,7,9,5,1,4,12,33.3,8,38,28,10,22,37,121,1
1474,6,6,1,2,3,0,3,0,3,7,0,7,1,7,9,0
1475,26,12,6,16,4,8,18,44.4,10,11,2,9,24,50,10,0
1476,0,0,0,0,0,0,0,,0,0,0,0,0,0,0,0
1477,17,12,12,3,2,9,16,56.3,7,6,0,6,8,25,14,0
1478,33,18,9,16,8,11,30,36.7,19,27,2,25,15,48,3,0
1479,36,23,20,8,8,21,39,53.8,18,28,4,24,19,55,49,1
1480,28,14,13,15,0,16,26,61.5,10,10,2,8,12,40,16,1
1481,2,1,1,1,0,1,2,50,1,2,0,2,0,2,1,0
1482,11,5,4,4,3,1,17,5.9,16,15,0,15,4,15,14,0
1483,70,44,25,36,9,41,90,45.6,49,25,1,24,29,99,18,0
1484,61,38,38,19,4,37,62,59.7,25,18,3,15,37,98,50,0
1485,17,8,16,1,0,8,10,80,2,9,5,4,14,31,32,0
1486,49,32,36,8,5,28,36,77.8,8,34,22,12,48,97,125,0
1487,0,0,0,0,0,0,1,0,1,0,0,0,0,0,0,0
1488,17,7,3,9,5,10,20,50,10,12,1,11,12,29,8,0
1489,0,0,0,0,0,0,0,,0,1,0,1,1,1,11,1
1490,3,1,3,0,0,3,4,75,1,0,0,0,1,4,21,4
1491,58,36,23,29,6,25,92,27.2,67,37,11,26,25,83,23,0
1492,3,2,1,2,0,3,8,37.5,5,4,0,4,4,7,3,0
1493,18,10,9,7,2,10,15,66.7,5,31,19,12,31,49,74,1
1494,55,30,26,25,4,15,53,28.3,38,27,10,17,28,83,37,0
1495,33,24,22,10,1,12,20,60,8,30,19,11,31,64,158,0
1496,32,23,16,12,4,22,44,50,22,37,12,25,23,55,63,0
1497,24,14,9,12,3,8,23,34.8,15,18,0,18,8,32,11,0
1498,0,0,0,0,0,0,1,0,1,0,0,0,0,0,0,0
1499,62,35,25,33,4,28,38,73.7,10,32,9,23,48,110,37,0
1500,35,22,20,14,1,17,41,41.5,24,21,4,17,14,49,24,1
1501,4,1,2,1,1,1,3,33.3,2,1,0,1,2,6,2,0
1502,3,3,1,2,0,3,8,37.5,5,4,0,4,2,5,6,0
1503,20,11,11,7,2,8,13,61.5,5,7,3,4,13,33,21,0
1504,33,17,10,13,10,10,34,29.4,24,26,4,22,9,42,14,0
1505,1,1,1,0,0,1,1,100,0,0,0,0,0,1,1,0
1506,29,15,22,6,1,12,21,57.1,9,9,4,5,7,36,21,0
1507,31,21,17,11,3,12,34,35.3,22,20,4,16,8,39,8,0
1508,0,0,0,0,0,0,0,,0,0,0,0,0,0,0,0
1509,10,3,0,6,4,5,17,29.4,12,17,2,15,6,16,8,0
1510,13,8,3,7,3,3,16,18.8,13,9,0,9,13,26,5,0
1511,8,6,6,1,1,3,4,75,1,3,2,1,3,11,8,0
1512,0,0,0,0,0,0,0,,0,1,0,1,0,0,0,0
1513,3,3,1,2,0,1,2,50,1,0,0,0,1,4,1,0
1514,0,0,0,0,0,0,0,,0,4,0,4,0,0,0,0
1515,71,43,40,21,10,46,77,59.7,31,12,0,12,21,92,28,0
1516,24,13,17,6,1,13,24,54.2,11,33,23,10,50,74,158,1
1517,34,19,21,13,0,15,18,83.3,3,31,21,10,26,60,103,0
1518,3,3,1,1,1,1,5,20,4,1,0,1,2,5,0,0
1519,2,0,1,1,0,0,2,0,2,1,0,1,2,4,1,0
1520,0,0,0,0,0,0,0,,0,0,0,0,1,1,1,1
1521,16,11,9,7,0,9,14,64.3,5,26,17,9,25,41,96,0
1522,28,13,6,13,9,12,36,33.3,24,30,0,30,24,52,11,1
1523,14,8,3,4,7,6,18,33.3,12,8,0,8,3,17,2,0
1524,9,7,4,3,2,2,6,33.3,4,4,0,4,0,9,1,0
1525,28,16,15,9,4,13,28,46.4,15,15,0,15,13,41,22,0
1526,54,28,30,18,6,27,45,60,18,23,9,14,47,101,50,1
1527,33,19,12,13,8,13,49,26.5,36,19,1,18,15,48,11,0
1528,2,1,0,1,1,1,2,50,1,1,0,1,0,2,0,0
1529,53,31,32,19,2,33,47,70.2,14,35,17,18,40,93,77,2
1530,51,23,25,22,4,28,43,65.1,15,33,10,23,27,78,44,0
1531,1,1,1,0,0,1,2,50,1,0,0,0,1,2,24,3
1532,8,4,4,2,2,4,10,40,6,6,1,5,1,9,0,1
1533,22,12,8,10,4,9,22,40.9,13,4,0,4,5,27,3,0
1534,4,3,3,0,1,1,2,50,1,6,1,5,1,5,1,0
1535,39,24,16,20,3,14,36,38.9,22,9,1,8,12,51,13,1
1536,0,0,0,0,0,0,0,,0,0,0,0,0,0,0,0
1537,4,2,1,0,3,1,1,100,0,1,0,1,1,5,2,0
1538,44,25,21,16,7,21,47,44.7,26,43,21,22,22,66,33,0
1539,28,19,13,11,4,14,24,58.3,10,20,8,12,14,42,15,0
1540,31,18,14,13,4,11,27,40.7,16,22,4,18,13,44,19,1
1541,29,10,16,11,2,10,19,52.6,9,15,6,9,11,40,17,0
1542,3,2,1,2,0,1,2,50,1,4,1,3,1,4,20,0
1543,9,5,2,4,3,1,1,100,0,4,0,4,0,9,2,0
1544,54,34,18,31,5,24,65,36.9,41,18,6,12,9,63,18,0
1545,32,14,10,13,9,10,28,35.7,18,19,1,18,10,42,4,0
1546,0,0,0,0,0,0,0,,0,0,0,0,3,3,12,3
1547,18,13,9,8,1,9,16,56.3,7,10,8,2,10,28,25,2
1548,0,0,0,0,0,0,2,0,2,0,0,0,1,1,21,1
1549,8,6,6,2,0,4,6,66.7,2,7,1,6,4,12,15,0
1550,69,36,40,27,2,35,87,40.2,52,33,7,26,42,111,38,1
1551,0,0,0,0,0,0,1,0,1,0,0,0,0,0,12,1
1552,19,9,6,10,3,10,33,30.3,23,7,0,7,10,29,8,1
1553,53,29,22,24,7,21,53,39.6,32,20,4,16,22,75,17,0
1554,7,5,2,3,2,5,8,62.5,3,2,0,2,5,12,9,0
1555,65,39,29,30,6,34,69,49.3,35,32,9,23,70,135,53,1
1556,0,0,0,0,0,0,0,,0,0,0,0,0,0,1,0
1557,1,0,1,0,0,1,1,100,0,0,0,0,1,2,3,3
1558,33,17,21,9,3,16,30,53.3,14,17,4,13,12,45,28,0
1559,0,0,0,0,0,0,0,,0,0,0,0,0,0,0,0
1560,49,22,26,22,1,17,45,37.8,28,30,11,19,37,86,68,1
1561,41,21,18,20,3,16,38,42.1,22,28,6,22,42,83,20,1
1562,5,4,4,1,0,0,1,0,1,4,2,2,7,12,8,0
1563,23,15,13,10,0,8,20,40,12,21,10,11,28,51,43,0
1564,28,22,12,11,5,10,43,23.3,33,17,2,15,9,37,15,1
1565,38,24,20,10,8,20,37,54.1,17,25,11,14,26,64,68,0
1566,8,4,2,3,3,5,18,27.8,13,16,2,14,2,10,7,0
1567,28,20,12,11,5,8,30,26.7,22,24,0,24,9,37,9,0
1568,43,25,14,24,5,17,40,42.5,23,15,5,10,13,56,4,1
1569,22,10,11,6,5,11,22,50,11,15,3,12,11,33,10,0
1570,42,25,22,17,3,17,35,48.6,18,21,2,19,21,63,11,1
1571,35,21,24,10,1,16,34,47.1,18,17,3,14,19,54,37,0
1572,27,17,6,9,12,12,42,28.6,30,29,0,29,4,31,7,0
1573,78,40,42,33,3,32,50,64,18,43,21,22,100,178,80,2
1574,0,0,0,0,0,0,0,,0,0,0,0,0,0,0,0
1575,59,39,30,24,5,21,72,29.2,51,30,7,23,34,93,28,1
1576,2,1,0,1,1,1,5,20,4,11,1,10,0,2,20,0
1577,34,19,27,7,0,15,23,65.2,8,18,9,9,38,72,64,2
1578,2,1,2,0,0,1,3,33.3,2,2,0,2,2,4,0,0
1579,7,4,3,2,2,1,10,10,9,5,0,5,13,20,4,0
1580,51,34,17,27,7,19,43,44.2,24,34,6,28,24,75,41,0
1581,0,0,0,0,0,0,2,0,2,0,0,0,0,0,2,0
1582,0,0,0,0,0,0,0,,0,0,0,0,0,0,2,0
1583,0,0,0,0,0,0,0,,0,0,0,0,0,0,0,0
1584,29,17,17,10,2,10,20,50,10,32,26,6,45,74,132,0
1585,0,0,0,0,0,0,1,0,1,0,0,0,0,0,11,4
1586,18,15,11,7,0,10,18,55.6,8,18,13,5,13,31,50,1
1587,19,12,16,1,2,11,20,55,9,18,8,10,31,50,73,0
1588,0,0,0,0,0,0,0,,0,0,0,0,0,0,1,0
1589,65,40,23,30,12,29,68,42.6,39,37,7,30,13,78,22,0
1590,16,14,11,1,4,12,14,85.7,2,9,1,8,3,19,12,1
1591,23,13,11,8,4,9,23,39.1,14,10,0,10,15,38,17,0
1592,41,22,24,14,3,16,42,38.1,26,18,4,14,18,59,27,0
1593,40,20,8,24,8,14,46,30.4,32,18,3,15,11,51,12,0
1594,0,0,0,0,0,0,0,,0,0,0,0,0,0,8,2
1595,84,47,48,28,8,38,69,55.1,31,30,13,17,46,130,74,0
1596,0,0,0,0,0,0,5,0,5,1,0,1,0,0,4,0
1597,58,32,20,32,6,31,77,40.3,46,30,5,25,29,87,33,0
1598,0,0,0,0,0,0,1,0,1,0,0,0,0,0,0,0
1599,5,4,4,1,0,1,9,11.1,8,3,1,2,1,6,3,0
1600,10,7,5,5,0,8,16,50,8,5,3,2,10,20,46,0
1601,4,2,4,0,0,1,1,100,0,2,2,0,7,11,12,0
1602,50,34,27,20,3,22,50,44,28,14,3,11,25,75,13,0
1603,53,31,22,26,5,24,42,57.1,18,17,7,10,20,73,36,0
1604,34,21,22,8,4,19,31,61.3,12,36,29,7,32,66,101,3
1605,11,3,5,4,2,5,19,26.3,14,15,1,14,6,17,6,0
1606,20,13,6,10,4,8,26,30.8,18,18,1,17,15,35,13,0
1607,47,28,29,13,5,24,48,50,24,20,7,13,14,61,18,0
1608,2,1,2,0,0,2,2,100,0,0,0,0,1,3,4,2
1609,8,4,5,3,0,2,4,50,2,2,0,2,4,12,4,0
1610,8,6,5,0,3,5,14,35.7,9,7,0,7,6,14,7,0
1611,0,0,0,0,0,0,0,,0,1,0,1,0,0,0,0
1612,5,3,2,3,0,5,10,50,5,2,0,2,0,5,1,0
1613,32,21,9,14,9,11,42,26.2,31,26,2,24,11,43,9,0
1614,30,21,7,17,6,15,29,51.7,14,26,6,20,19,49,17,0
1615,2,2,0,0,2,0,1,0,1,1,0,1,3,5,2,0
1616,56,32,24,26,6,18,49,36.7,31,42,13,29,71,127,41,0
1617,14,6,10,4,0,7,9,77.8,2,17,11,6,12,26,61,1
1618,4,2,4,0,0,2,2,100,0,3,0,3,8,12,6,0
1619,8,3,4,3,1,2,6,33.3,4,4,0,4,1,9,0,0
1620,27,16,8,13,6,12,25,48,13,14,1,13,6,33,2,0
1621,13,10,4,5,4,7,13,53.8,6,10,0,10,10,23,11,0
1622,18,10,3,10,5,5,19,26.3,14,27,3,24,5,23,1,0
1623,45,25,24,19,2,16,31,51.6,15,23,9,14,20,65,53,0
1624,1,0,1,0,0,1,1,100,0,0,0,0,0,1,0,0
1625,37,17,16,18,3,15,42,35.7,27,20,8,12,18,55,15,0
1626,0,0,0,0,0,0,0,,0,0,0,0,0,0,6,1
1627,19,12,3,11,5,6,26,23.1,20,16,0,16,4,23,13,0
1628,18,12,8,7,3,9,21,42.9,12,5,2,3,5,23,6,0
1629,32,19,18,13,1,14,37,37.8,23,23,6,17,32,64,72,0
1630,41,25,22,18,1,18,33,54.5,15,38,19,19,39,80,69,0
1631,1,1,0,1,0,0,6,0,6,2,0,2,1,2,2,0
1632,0,0,0,0,0,0,1,0,1,1,0,1,1,1,4,1
1633,45,25,30,14,1,22,30,73.3,8,18,9,9,21,66,38,0
1634,43,23,29,11,3,32,51,62.7,19,13,4,9,37,80,55,0
1635,11,5,2,8,1,3,6,50,3,17,14,3,13,24,49,3
1636,21,10,3,16,2,12,21,57.1,9,18,4,14,10,31,13,0
1637,0,0,0,0,0,0,0,,0,0,0,0,0,0,9,0
1638,33,20,7,14,12,8,26,30.8,18,30,1,29,8,41,15,0
1639,17,12,12,5,0,8,12,66.7,4,11,8,3,17,34,61,1
1640,17,10,5,7,5,11,22,50,11,11,4,7,12,29,19,1
1641,58,30,23,34,1,31,68,45.6,37,38,11,27,36,94,29,0
1642,35,22,22,8,5,26,41,63.4,15,18,4,14,25,60,47,3
1643,2,2,1,1,0,2,3,66.7,1,2,1,1,4,6,10,1
1644,39,29,28,10,1,21,36,58.3,15,15,6,9,10,49,32,0
1645,1,0,0,1,0,0,0,,0,1,0,1,0,1,0,0
1646,7,4,5,1,1,3,9,33.3,6,5,0,5,1,8,6,0
1647,8,4,1,1,6,1,8,12.5,7,7,0,7,2,10,6,0
1648,15,11,4,6,5,5,16,31.3,11,15,0,15,7,22,13,0
1649,13,9,12,1,0,9,15,60,6,17,13,4,15,28,51,0
1650,42,22,27,14,1,21,37,56.8,16,25,4,21,28,70,52,0
1651,8,4,2,3,3,5,10,50,5,7,2,5,1,9,11,0
1652,9,5,7,2,0,4,6,66.7,2,4,3,1,13,22,46,1
1653,4,3,0,4,0,4,6,66.7,2,3,2,1,4,8,10,0
1654,30,17,11,9,10,7,22,31.8,15,22,3,19,17,47,25,0
1655,21,15,11,8,2,11,16,68.8,5,15,6,9,10,31,24,0
1656,16,11,10,6,0,10,23,43.5,13,37,27,10,43,59,114,2
1657,24,14,17,6,1,12,24,50,12,8,3,5,12,36,13,0
1658,50,37,24,19,7,28,43,65.1,15,20,3,17,19,69,27,0
1659,0,0,0,0,0,0,0,,0,0,0,0,0,0,0,0
1660,14,7,3,10,1,7,8,87.5,1,4,1,3,7,21,2,0
1661,5,3,1,3,1,3,6,50,3,5,4,1,3,8,10,0
1662,16,8,8,6,2,8,16,50,8,18,12,6,21,37,72,0
1663,18,12,12,6,0,8,16,50,8,25,19,6,25,43,96,1
1664,2,0,2,0,0,0,0,,0,2,0,2,1,3,3,0
1665,42,21,16,22,4,24,54,44.4,30,23,5,18,10,52,17,1
1666,36,24,27,9,0,20,40,50,20,21,14,7,25,61,66,1
1667,0,0,0,0,0,0,0,,0,0,0,0,0,0,0,0
1668,0,0,0,0,0,0,0,,0,0,0,0,0,0,0,0
1669,26,17,6,14,6,4,20,20,16,9,1,8,7,33,6,0
1670,37,14,25,11,1,20,35,57.1,15,35,19,16,16,53,102,0
1671,23,14,3,13,7,8,30,26.7,22,14,0,14,2,25,8,0
1672,0,0,0,0,0,0,1,0,1,1,0,1,0,0,1,0
1673,2,1,0,0,2,2,6,33.3,4,4,0,4,0,2,3,0
1674,2,2,0,2,0,0,0,,0,1,0,1,1,3,3,0
1675,54,33,32,18,4,24,55,43.6,31,24,4,20,20,74,35,0
1676,1,0,0,1,0,1,1,100,0,0,0,0,3,4,1,0
1677,0,0,0,0,0,0,1,0,1,1,0,1,0,0,0,0
1678,0,0,0,0,0,0,0,,0,0,0,0,0,0,1,0
1679,1,1,1,0,0,0,1,0,1,2,0,2,1,2,1,0
1680,35,20,12,21,2,19,53,35.8,34,17,3,14,22,57,28,1
1681,27,19,7,14,6,10,29,34.5,19,26,1,25,20,47,15,0
1682,1,1,1,0,0,1,3,33.3,2,0,0,0,0,1,6,1
1683,28,13,18,7,3,14,23,60.9,9,22,10,12,39,67,143,0
1684,21,14,8,11,2,10,29,34.5,19,6,0,6,9,30,10,0
1685,0,0,0,0,0,0,0,,0,0,0,0,0,0,0,0
1686,20,10,3,10,7,6,11,54.5,5,21,1,20,18,38,6,0
1687,15,8,7,8,0,4,13,30.8,9,6,3,3,15,30,5,0
1688,36,25,23,11,2,21,34,61.8,13,22,9,13,19,55,46,0
1689,42,27,10,26,6,21,59,35.6,38,26,1,25,17,59,4,0
1690,30,18,16,12,2,13,32,40.6,19,19,8,11,41,71,71,0
1691,46,26,16,23,7,24,60,40,36,42,14,28,48,94,52,2
1692,5,3,4,1,0,4,7,57.1,3,8,4,4,11,16,20,1
1693,24,13,11,10,3,12,29,41.4,17,18,6,12,18,42,45,0
1694,35,20,21,13,1,21,33,63.6,12,28,19,9,34,69,64,1
1695,14,5,6,7,1,4,16,25,12,9,0,9,3,17,6,0
1696,31,23,19,11,1,14,23,60.9,9,9,1,8,9,40,17,0
1697,7,5,3,1,3,1,9,11.1,8,4,1,3,1,8,5,0
1698,6,4,2,3,1,3,5,60,2,1,0,1,1,7,1,0
1699,45,26,21,23,1,18,39,46.2,21,33,3,30,29,74,22,0
1700,8,7,4,4,0,2,11,18.2,9,11,3,8,13,21,9,0
1701,16,12,10,5,1,13,29,44.8,16,10,6,4,9,25,15,0
1702,8,4,2,5,1,3,18,16.7,15,11,3,8,4,12,13,0
1703,31,18,19,11,1,15,31,48.4,16,21,6,15,31,62,21,3
1704,47,34,23,19,5,20,31,64.5,11,26,14,12,44,91,93,1
1705,3,2,1,2,0,2,7,28.6,5,3,3,0,1,4,6,1
1706,58,32,28,26,4,26,55,47.3,29,49,19,30,62,120,43,0
1707,17,10,2,6,9,4,18,22.2,14,21,2,19,2,19,2,0
1708,24,13,11,7,6,14,39,35.9,25,23,2,21,8,32,11,0
1709,57,39,35,21,1,30,51,58.8,21,46,23,23,69,126,174,2
1710,10,9,3,6,1,3,10,30,7,1,0,1,5,15,2,0
1711,3,1,3,0,0,3,6,50,3,0,0,0,1,4,16,2
1712,0,0,0,0,0,0,0,,0,0,0,0,0,0,0,0
1713,7,5,2,3,2,1,2,50,1,10,4,6,4,11,3,0
1714,1,0,0,0,1,1,1,100,0,0,0,0,0,1,1,0
1715,18,8,11,4,3,10,26,38.5,16,11,8,3,21,39,31,1
1716,28,19,15,11,2,14,34,41.2,20,5,0,5,11,39,31,0
1717,31,20,21,5,5,12,23,52.2,11,25,8,17,35,66,35,0
1718,11,8,1,4,6,7,13,53.8,6,6,0,6,5,16,13,0
1719,1,1,1,0,0,1,2,50,1,1,1,0,1,2,6,0
1720,19,10,10,9,0,11,22,50,11,7,2,5,10,29,19,0
1721,28,16,1,12,15,6,20,30,14,21,6,15,11,39,20,0
1722,0,0,0,0,0,0,0,,0,0,0,0,0,0,0,0
1723,8,2,3,3,2,5,9,55.6,4,7,1,6,3,11,3,0
1724,6,6,3,2,1,3,3,100,0,0,0,0,1,7,6,0
1725,14,13,4,7,3,2,8,25,6,14,0,14,11,25,4,0
1726,33,23,13,19,1,16,44,36.4,28,23,9,14,30,63,27,0
1727,0,0,0,0,0,0,2,0,2,0,0,0,0,0,0,0
1728,0,0,0,0,0,0,0,,0,0,0,0,0,0,0,0
1729,0,0,0,0,0,0,0,,0,1,0,1,0,0,0,0
1730,0,0,0,0,0,0,0,,0,0,0,0,0,0,4,0
1731,106,64,35,55,16,54,104,51.9,50,53,6,47,35,141,34,0
1732,20,11,11,7,2,8,26,30.8,18,17,8,9,23,43,20,0
1733,0,0,0,0,0,0,0,,0,0,0,0,0,0,0,0
1734,42,22,18,20,4,17,59,28.8,42,29,7,22,34,76,54,0
1735,78,49,27,38,13,33,73,45.2,40,64,11,53,35,113,31,1
1736,65,33,32,24,9,30,61,49.2,31,45,10,35,31,96,60,1
1737,39,23,27,11,1,16,36,44.4,20,30,21,9,44,83,112,0
1738,61,42,34,23,4,38,62,61.3,24,24,8,16,37,98,78,3
1739,17,10,11,6,0,6,10,60,4,14,3,11,10,27,28,0
1740,26,12,16,7,3,12,19,63.2,7,28,22,6,24,50,94,1
1741,0,0,0,0,0,0,0,,0,0,0,0,0,0,0,0
1742,2,1,1,1,0,1,1,100,0,0,0,0,0,2,0,0
1743,0,0,0,0,0,0,1,0,1,1,0,1,0,0,1,0
1744,20,12,5,8,7,8,16,50,8,10,1,9,11,31,8,1
1745,11,5,4,4,3,3,13,23.1,10,4,1,3,1,12,10,0
1746,29,16,10,15,4,16,36,44.4,20,21,8,13,7,36,22,0
1747,43,27,25,11,7,23,31,74.2,8,23,7,16,22,65,40,0
1748,25,12,10,14,1,13,24,54.2,11,11,2,9,7,32,8,1
1749,10,4,2,4,4,3,13,23.1,10,9,1,8,3,13,4,0
1750,58,28,37,18,3,40,57,70.2,17,41,21,20,41,99,128,4
1751,48,29,23,18,7,25,47,53.2,22,27,5,22,21,69,17,1
1752,1,1,1,0,0,0,0,,0,1,1,0,0,1,2,0
1753,36,22,18,16,2,12,30,40,18,24,5,19,34,70,56,1
1754,0,0,0,0,0,0,0,,0,0,0,0,0,0,1,0
1755,68,35,24,35,9,26,87,29.9,61,52,6,46,37,105,30,0
1756,25,14,11,10,4,11,34,32.4,23,16,0,16,4,29,17,0
1757,6,4,4,2,0,2,11,18.2,9,6,1,5,7,13,17,0
1758,49,28,21,22,6,23,45,51.1,22,37,6,31,34,83,40,0
1759,2,2,1,1,0,2,6,33.3,4,0,0,0,0,2,0,0
1760,1,0,1,0,0,1,3,33.3,2,0,0,0,0,1,13,4
1761,24,14,11,10,3,8,14,57.1,6,8,2,6,18,42,27,3
1762,12,6,8,4,0,6,17,35.3,11,7,4,3,11,23,11,1
1763,37,24,19,12,6,18,38,47.4,20,11,2,9,16,53,21,0
1764,9,6,3,6,0,4,7,57.1,3,6,4,2,10,19,19,0
1765,0,0,0,0,0,0,0,,0,0,0,0,0,0,3,1
1766,7,3,5,2,0,4,10,40,6,1,0,1,6,13,1,0
1767,71,38,21,40,10,26,67,38.8,41,50,10,40,21,92,56,2
1768,45,28,19,20,6,26,49,53.1,23,25,4,21,27,72,29,2
1769,2,1,2,0,0,2,6,33.3,4,2,0,2,0,2,1,0
1770,1,0,1,0,0,1,1,100,0,0,0,0,0,1,2,0
1771,16,7,1,11,4,3,16,18.8,13,8,2,6,9,25,2,0
1772,1,1,1,0,0,1,1,100,0,0,0,0,0,1,27,1
1773,10,3,1,5,4,3,13,23.1,10,5,0,5,4,14,0,0
1774,34,18,11,14,9,15,34,44.1,19,11,1,10,17,51,17,0
1775,29,19,13,12,4,16,33,48.5,17,10,2,8,12,41,25,1
1776,14,10,11,3,0,11,17,64.7,6,12,7,5,21,35,60,2
1777,53,35,22,22,9,24,37,64.9,13,38,19,19,47,100,64,1
1778,7,7,3,4,0,2,7,28.6,5,14,12,2,11,18,55,1
1779,4,1,2,2,0,1,2,50,1,2,1,1,1,5,1,1
1780,10,6,5,3,2,2,8,25,6,3,0,3,1,11,1,0
1781,0,0,0,0,0,0,2,0,2,2,0,2,1,1,2,0
1782,7,3,1,5,1,2,15,13.3,13,6,0,6,1,8,7,0
1783,1,1,0,1,0,0,1,0,1,2,0,2,0,1,0,0
1784,1,1,0,1,0,0,0,,0,0,0,0,0,1,1,0
1785,2,0,0,1,1,0,0,,0,0,0,0,0,2,0,0
1786,0,0,0,0,0,0,0,,0,0,0,0,0,0,0,0
1787,11,5,6,4,1,6,9,66.7,3,6,3,3,5,16,9,0
1788,54,32,31,20,3,29,34,85.3,5,30,15,15,39,93,94,0
1789,9,2,0,5,4,4,18,22.2,14,9,1,8,3,12,10,1
1790,67,44,20,32,15,29,67,43.3,38,50,9,41,34,101,43,1
1791,0,0,0,0,0,0,1,0,1,0,0,0,0,0,7,2
1792,50,32,30,12,8,20,39,51.3,19,42,20,22,52,102,107,3
1793,18,9,9,6,3,10,16,62.5,6,6,1,5,11,29,15,0
1794,59,29,25,30,4,25,64,39.1,39,28,4,24,25,84,34,0
1795,20,15,14,5,1,8,44,18.2,36,21,1,20,5,25,21,0
1796,2,0,0,2,0,0,1,0,1,0,0,0,1,3,1,0
1797,28,16,12,11,5,12,29,41.4,17,19,5,14,17,45,20,0
1798,27,17,8,15,4,5,32,15.6,27,28,2,26,6,33,22,0
1799,12,10,12,0,0,10,13,76.9,3,13,9,4,11,23,38,1
1800,3,2,1,1,1,2,8,25,6,2,0,2,1,4,2,0
1801,23,12,17,3,3,14,22,63.6,8,47,30,17,46,69,153,2
1802,25,11,12,11,2,16,23,69.6,7,5,0,5,9,34,22,1
1803,4,3,1,1,2,0,11,0,11,4,3,1,0,4,17,0
1804,36,19,16,12,8,15,44,34.1,29,15,3,12,35,71,58,0
1805,11,7,3,7,1,4,12,33.3,8,3,0,3,1,12,7,0
1806,21,11,16,4,1,12,22,54.5,10,10,4,6,15,36,22,0
1807,4,2,2,2,0,2,9,22.2,7,3,1,2,2,6,3,0
1808,104,57,67,26,11,46,67,68.7,21,47,5,42,41,145,101,0
1809,16,8,12,4,0,8,13,61.5,5,28,18,10,22,38,114,1
1810,52,33,30,12,10,26,50,52,24,28,5,23,46,98,37,0
1811,45,29,11,27,7,17,52,32.7,35,33,2,31,22,67,33,0
1812,42,25,18,17,7,23,42,54.8,19,25,2,23,10,52,22,1
1813,10,6,4,5,1,3,18,16.7,15,11,2,9,4,14,29,0
1814,6,3,4,2,0,2,5,40,3,6,6,0,4,10,26,0
1815,18,10,8,7,3,6,27,22.2,21,10,4,6,20,38,9,0
1816,17,10,3,12,2,9,32,28.1,23,11,2,9,4,21,22,0
1817,7,1,3,3,1,1,7,14.3,6,3,0,3,3,10,6,0
1818,0,0,0,0,0,0,0,,0,1,0,1,1,1,1,0
1819,46,25,34,7,5,23,31,74.2,8,22,3,19,25,71,61,3
1820,3,1,2,1,0,2,4,50,2,5,5,0,3,6,2,0
1821,4,2,2,1,1,2,18,11.1,16,13,2,11,6,10,11,0
1822,41,24,17,21,3,16,48,33.3,32,24,3,21,22,63,44,2
1823,12,9,10,2,0,5,7,71.4,2,7,2,5,6,18,20,0
1824,31,22,14,12,5,14,57,24.6,43,27,4,23,24,55,13,0
1825,40,20,18,18,4,17,44,38.6,27,26,9,17,20,60,43,0
1826,15,6,5,9,1,5,10,50,5,8,3,5,4,19,4,0
1827,41,25,19,17,5,20,57,35.1,37,21,10,11,22,63,51,1
1828,15,4,8,5,2,12,24,50,12,8,2,6,10,25,22,0
1829,0,0,0,0,0,0,0,,0,0,0,0,1,1,16,3
1830,26,13,16,7,3,17,27,63,10,11,1,10,11,37,29,1
1831,20,12,11,7,2,15,26,57.7,11,6,0,6,11,31,20,0
1832,0,0,0,0,0,0,0,,0,0,0,0,0,0,0,0
1833,18,9,4,9,5,8,31,25.8,23,26,1,25,5,23,24,0
1834,11,6,3,7,1,6,18,33.3,12,11,2,9,6,17,8,0
1835,3,0,1,2,0,3,4,75,1,1,0,1,0,3,0,0
1836,13,9,8,4,1,6,6,100,0,9,7,2,7,20,31,0
1837,13,7,5,7,1,5,18,27.8,13,13,1,12,27,40,15,0
1838,76,40,53,15,8,33,60,55,27,28,6,22,34,110,82,1
1839,5,2,2,2,1,1,7,14.3,6,6,1,5,6,11,14,0
1840,21,14,13,7,1,7,28,25,21,30,1,29,12,33,12,0
1841,26,18,10,13,3,14,35,40,21,15,0,15,12,38,14,0
1842,0,0,0,0,0,0,4,0,4,2,0,2,1,1,0,0
1843,36,15,16,17,3,18,43,41.9,25,24,5,19,13,49,17,0
1844,3,3,0,2,1,1,5,20,4,2,0,2,0,3,0,0
1845,6,4,1,3,2,0,12,0,12,11,1,10,2,8,9,0
1846,1,1,1,0,0,1,1,100,0,0,0,0,0,1,0,0
1847,0,0,0,0,0,0,2,0,2,0,0,0,3,3,0,0
1848,4,2,3,0,1,3,6,50,3,1,0,1,3,7,1,1
1849,8,4,4,3,1,2,5,40,3,3,0,3,2,10,0,0
1850,0,0,0,0,0,0,0,,0,0,0,0,0,0,0,0
1851,1,1,0,1,0,0,0,,0,2,2,0,2,3,1,0
1852,4,3,2,2,0,1,3,33.3,2,3,0,3,1,5,1,0
1853,7,4,2,3,2,2,8,25,6,3,0,3,2,9,4,0
1854,1,0,0,1,0,0,1,0,1,5,0,5,3,4,0,0
1855,25,12,17,8,0,14,25,56,11,27,14,13,35,60,48,0
1856,0,0,0,0,0,0,0,,0,0,0,0,1,1,7,0
1857,17,6,3,12,2,4,27,14.8,23,13,1,12,6,23,12,0
1858,41,16,10,17,14,10,34,29.4,24,18,1,17,13,54,12,0
1859,25,10,7,14,4,8,35,22.9,27,19,0,19,18,43,19,0
1860,1,0,0,1,0,0,0,,0,2,0,2,0,1,0,0
1861,74,39,34,27,13,30,106,28.3,76,48,8,40,34,108,36,2
1862,48,32,20,20,8,23,62,37.1,39,14,2,12,17,65,16,0
1863,23,10,7,13,3,13,43,30.2,30,18,5,13,20,43,18,0
1864,0,0,0,0,0,0,0,,0,1,0,1,0,0,0,0
1865,35,22,23,9,3,14,27,51.9,13,31,5,26,31,66,44,2
1866,52,35,43,7,2,27,49,55.1,22,25,6,19,24,76,44,1
1867,0,0,0,0,0,0,1,0,1,1,0,1,0,0,13,2
1868,35,20,7,16,12,16,54,29.6,38,32,1,31,15,50,12,0
1869,1,1,1,0,0,0,0,,0,0,0,0,0,1,5,0
1870,34,17,21,11,2,17,39,43.6,22,39,13,26,43,77,72,2
1871,32,10,8,19,5,12,40,30,28,20,1,19,17,49,8,1
1872,28,17,14,13,1,18,29,62.1,11,11,1,10,17,45,34,0
1873,15,4,2,7,6,3,19,15.8,16,12,0,12,4,19,5,0
1874,15,10,13,2,0,9,13,69.2,4,11,8,3,17,32,37,0
1875,1,0,1,0,0,0,5,0,5,0,0,0,0,1,2,0
1876,6,3,1,3,2,1,7,14.3,6,12,0,12,6,12,29,0
1877,49,26,34,11,4,26,41,63.4,15,20,2,18,23,72,17,0
1878,22,17,10,11,1,8,13,61.5,5,17,3,14,7,29,20,1
1879,23,13,8,8,7,6,20,30,14,19,1,18,14,37,11,0
1880,0,0,0,0,0,0,0,,0,0,0,0,0,0,0,0
1881,40,26,11,16,13,15,36,41.7,21,25,0,25,19,59,2,1
1882,1,1,1,0,0,0,0,,0,0,0,0,0,1,17,1
1883,9,6,6,3,0,5,9,55.6,4,6,3,3,15,24,40,0
1884,5,2,4,1,0,3,3,100,0,1,0,1,0,5,1,0
1885,22,12,10,10,2,5,27,18.5,22,20,2,18,12,34,19,0
1886,25,15,15,7,3,12,21,57.1,9,15,2,13,16,41,37,0
1887,21,11,6,9,6,12,27,44.4,15,18,2,16,14,35,13,0
1888,60,34,29,27,4,44,59,74.6,15,46,20,26,48,108,137,0
1889,10,8,3,5,2,3,20,15,17,24,5,19,19,29,21,0
1890,0,0,0,0,0,0,1,0,1,1,1,0,2,2,1,0
1891,66,45,38,23,5,36,63,57.1,27,28,7,21,29,95,30,0
1892,18,14,9,9,0,12,22,54.5,10,22,15,7,34,52,50,0
1893,57,35,37,18,2,23,38,60.5,15,29,15,14,60,117,84,0
1894,32,19,18,14,0,12,34,35.3,22,14,4,10,12,44,17,1
1895,39,21,16,15,8,18,33,54.5,15,16,1,15,9,48,15,1
1896,2,1,1,1,0,0,1,0,1,1,0,1,2,4,0,1
1897,1,0,1,0,0,1,2,50,1,0,0,0,0,1,10,2
1898,6,3,0,5,1,3,9,33.3,6,4,2,2,7,13,5,0
1899,1,1,1,0,0,1,1,100,0,1,1,0,5,6,11,0
1900,5,3,1,1,3,3,5,60,2,2,0,2,2,7,2,0
1901,28,19,21,6,1,13,27,48.1,14,11,5,6,22,50,56,2
1902,18,13,11,5,2,9,17,52.9,8,15,2,13,17,35,26,1
1903,0,0,0,0,0,0,0,,0,0,0,0,0,0,5,1
1904,15,10,8,7,0,8,18,44.4,10,4,1,3,10,25,9,0
1905,60,32,32,27,1,22,55,40,33,36,8,28,42,102,54,1
1906,10,7,3,5,2,1,8,12.5,7,5,0,5,1,11,1,0
1907,25,14,5,17,3,12,19,63.2,7,8,3,5,3,28,6,2
1908,0,0,0,0,0,0,2,0,2,4,0,4,0,0,0,0
1909,5,3,3,1,1,2,3,66.7,1,0,0,0,0,5,1,0
1910,5,3,1,4,0,3,6,50,3,11,5,6,2,7,23,0
1911,1,0,0,0,1,0,1,0,1,1,0,1,0,1,0,0
1912,3,2,2,1,0,1,3,33.3,2,5,1,4,6,9,11,1
1913,0,0,0,0,0,0,3,0,3,0,0,0,0,0,4,0
1914,0,0,0,0,0,0,0,,0,0,0,0,0,0,2,1
1915,4,4,2,0,2,0,9,0,9,0,0,0,6,10,1,0
1916,24,11,12,10,2,11,40,27.5,29,24,4,20,13,37,33,1
1917,2,1,2,0,0,1,2,50,1,0,0,0,0,2,7,1
1918,55,28,24,26,5,27,64,42.2,37,38,6,32,31,86,19,4
1919,31,19,24,7,0,16,28,57.1,12,27,9,18,32,63,81,0
1920,68,37,23,41,4,24,87,27.6,63,39,5,34,41,109,49,3
1921,29,19,5,12,12,12,36,33.3,24,9,1,8,4,33,2,1
1922,29,13,14,12,3,9,27,33.3,18,8,3,5,23,52,13,0
1923,31,18,23,5,3,11,26,42.3,15,11,4,7,12,43,32,0
1924,3,1,1,1,1,1,2,50,1,3,0,3,0,3,1,0
1925,21,14,9,6,6,5,14,35.7,9,13,3,10,2,23,9,0
1926,3,2,1,2,0,2,3,66.7,1,2,1,1,0,3,1,0
1927,8,7,8,0,0,4,11,36.4,7,5,3,2,27,35,34,0
1928,40,23,25,13,2,20,33,60.6,13,37,11,26,50,90,69,1
1929,1,1,0,1,0,0,5,0,5,6,1,5,3,4,16,0
1930,4,0,0,2,2,0,4,0,4,9,1,8,1,5,4,0
1931,11,7,7,3,1,7,11,63.6,4,7,2,5,7,18,17,0
1932,2,2,0,2,0,2,3,66.7,1,1,1,0,1,3,2,0
1933,6,5,1,3,2,4,13,30.8,9,9,0,9,4,10,7,0
1934,17,12,5,11,1,8,21,38.1,13,18,1,17,7,24,22,0
1935,20,9,11,9,0,9,16,56.3,7,14,3,11,7,27,10,1
1936,7,2,0,6,1,3,4,75,1,7,1,6,0,7,3,0
1937,39,26,29,7,3,22,34,64.7,12,48,24,24,49,88,132,1
1938,37,19,24,13,0,20,26,76.9,6,36,23,13,56,93,143,1
1939,5,1,1,4,0,2,5,40,3,2,0,2,1,6,0,0
1940,10,4,3,2,5,2,12,16.7,10,9,2,7,3,13,15,0
1941,9,4,1,4,4,1,4,25,3,9,2,7,4,13,5,0
1942,1,0,0,1,0,0,0,,0,2,1,1,2,3,8,0
1943,23,10,10,11,2,9,35,25.7,26,23,2,21,15,38,15,0
1944,3,1,1,1,1,0,2,0,2,2,0,2,7,10,6,0
1945,12,5,5,5,2,5,19,26.3,14,9,1,8,4,16,10,0
1946,8,2,7,1,0,5,11,45.5,6,4,1,3,4,12,2,1
1947,0,0,0,0,0,0,0,,0,0,0,0,0,0,0,0
1948,25,15,14,7,4,13,47,27.7,34,20,1,19,9,34,5,0
1949,21,11,8,8,5,8,22,36.4,14,19,0,19,6,27,8,0
1950,7,6,2,4,1,4,4,100,0,2,1,1,10,17,11,0
1951,34,21,19,14,1,17,46,37,29,17,8,9,19,53,43,1
1952,1,0,0,1,0,0,1,0,1,1,1,0,0,1,0,0
1953,4,4,2,0,2,2,7,28.6,5,2,0,2,1,5,0,0
1954,1,1,1,0,0,0,1,0,1,1,0,1,0,1,2,0
1955,1,1,0,0,1,0,0,,0,0,0,0,0,1,1,0
1956,24,13,9,11,4,8,19,42.1,11,21,1,20,8,32,12,0
1957,0,0,0,0,0,0,1,0,1,0,0,0,0,0,11,1
1958,0,0,0,0,0,0,1,0,1,0,0,0,0,0,1,0
1959,4,4,2,2,0,3,6,50,3,9,8,1,8,12,26,2
1960,16,11,9,7,0,10,14,71.4,4,8,5,3,14,30,21,0
1961,38,24,24,13,1,15,34,44.1,19,42,31,11,22,60,101,0
1962,5,5,0,4,1,4,10,40,6,8,3,5,3,8,10,0
1963,35,21,24,9,2,20,27,74.1,7,25,16,9,25,60,90,1
1964,3,1,2,1,0,2,2,100,0,2,1,1,2,5,7,0
1965,2,2,0,0,2,1,6,16.7,5,8,0,8,0,2,13,0
1966,109,60,42,58,9,52,101,51.5,49,48,9,39,64,173,58,1
1967,8,5,6,2,0,5,6,83.3,1,6,4,2,4,12,11,0
1968,23,14,5,14,4,5,12,41.7,7,17,6,11,10,33,7,0
1969,0,0,0,0,0,0,0,,0,0,0,0,1,1,10,4
1970,45,24,23,18,4,23,55,41.8,32,35,1,34,9,54,24,1
1971,24,15,15,7,2,10,13,76.9,3,10,2,8,12,36,21,0
1972,0,0,0,0,0,0,0,,0,0,0,0,0,0,0,0
1973,25,15,12,6,7,15,32,46.9,17,17,6,11,8,33,25,2
1974,7,4,5,2,0,3,7,42.9,4,5,4,1,11,18,29,0
1975,31,17,18,12,1,17,31,54.8,14,41,27,14,37,68,89,0
1976,0,0,0,0,0,0,0,,0,2,0,2,0,0,1,0
1977,16,10,4,9,3,3,20,15,17,19,3,16,10,26,20,0
1978,46,25,18,22,6,12,37,32.4,25,29,1,28,20,66,13,0
1979,5,3,3,1,1,1,1,100,0,5,1,4,4,9,6,0
1980,0,0,0,0,0,0,0,,0,0,0,0,0,0,0,0
1981,0,0,0,0,0,0,0,,0,0,0,0,1,1,0,0
1982,22,18,8,11,3,7,24,29.2,17,17,0,17,6,28,6,0
1983,2,2,2,0,0,1,4,25,3,0,0,0,0,2,0,0
1984,33,20,22,9,2,12,23,52.2,11,17,7,10,28,61,63,0
1985,27,14,11,14,2,15,30,50,15,13,0,13,10,37,7,0
1986,79,47,39,34,6,40,69,58,29,45,4,41,55,134,67,1
1987,14,6,5,7,2,5,18,27.8,13,5,1,4,4,18,1,0
1988,0,0,0,0,0,0,0,,0,0,0,0,0,0,0,0
1989,33,17,22,10,1,15,23,65.2,8,20,13,7,31,64,94,5
1990,2,1,2,0,0,2,3,66.7,1,0,0,0,0,2,12,3
1991,8,6,5,3,0,5,11,45.5,6,8,8,0,5,13,13,0
1992,48,31,17,27,4,18,25,72,7,10,3,7,30,78,19,0
1993,70,49,33,33,4,35,86,40.7,51,37,5,32,36,106,23,1
1994,18,10,4,6,8,7,22,31.8,15,27,2,25,7,25,8,0
1995,0,0,0,0,0,0,2,0,2,0,0,0,1,1,0,1
1996,0,0,0,0,0,0,0,,0,0,0,0,0,0,1,0
1997,25,17,13,9,3,8,27,29.6,19,16,2,14,14,39,13,0
1998,32,22,20,11,1,13,25,52,12,40,24,16,44,76,123,2
1999,0,0,0,0,0,0,2,0,2,1,0,1,1,1,2,0
2000,21,13,9,11,1,13,29,44.8,16,9,4,5,5,26,14,0
2001,1,0,1,0,0,1,2,50,1,2,0,2,0,1,5,1
2002,0,0,0,0,0,0,0,,0,0,0,0,0,0,1,0
2003,10,5,1,2,7,2,6,33.3,4,16,3,13,3,13,17,0
2004,1,1,0,1,0,0,0,,0,0,0,0,1,2,3,0
2005,0,0,0,0,0,0,0,,0,0,0,0,1,1,11,1
2006,9,6,3,5,1,3,7,42.9,4,7,1,6,11,20,8,0
2007,1,0,0,0,1,1,3,33.3,2,0,0,0,1,2,0,0
2008,36,23,13,21,2,16,39,41,23,9,3,6,18,54,11,0
2009,14,10,7,4,3,8,15,53.3,7,11,6,5,4,18,9,0
2010,21,15,9,11,1,11,23,47.8,12,10,1,9,14,35,15,1
2011,34,18,19,13,2,18,32,56.3,14,14,3,11,27,61,21,0
2012,0,0,0,0,0,0,1,0,1,1,0,1,1,1,17,2
2013,39,22,16,22,1,11,40,27.5,29,19,1,18,26,65,13,0
2014,6,1,0,3,3,3,7,42.9,4,3,0,3,2,8,3,0
2015,0,0,0,0,0,0,0,,0,0,0,0,0,0,1,0
2016,27,14,16,9,2,15,31,48.4,16,42,33,9,72,99,172,1
2017,15,11,2,8,5,3,14,21.4,11,12,2,10,6,21,5,0
2018,18,10,7,7,4,7,21,33.3,14,18,2,16,10,28,16,1
2019,13,4,7,4,2,9,15,60,6,5,1,4,6,19,17,0
2020,42,30,14,23,5,22,51,43.1,29,37,5,32,51,93,35,1
2021,14,11,6,5,3,7,17,41.2,10,3,0,3,4,18,12,0
2022,2,1,2,0,0,2,2,100,0,0,0,0,0,2,18,1
2023,6,4,4,2,0,3,3,100,0,6,4,2,6,12,18,0
2024,4,2,2,1,1,1,3,33.3,2,2,0,2,1,5,4,0
2025,0,0,0,0,0,0,0,,0,0,0,0,0,0,2,1
2026,0,0,0,0,0,0,1,0,1,0,0,0,0,0,0,0
2027,86,56,35,47,4,20,46,43.5,26,33,6,27,51,137,38,0
2028,30,19,12,14,4,15,38,39.5,23,20,1,19,28,58,11,2
2029,69,38,56,10,3,37,55,67.3,18,21,8,13,18,87,61,0
2030,42,28,20,19,3,18,59,30.5,41,31,3,28,13,55,22,0
2031,51,33,40,11,0,34,59,57.6,25,40,19,21,53,104,116,1
2032,2,1,1,1,0,0,2,0,2,3,0,3,1,3,0,0
2033,37,22,29,8,0,20,26,76.9,6,26,18,8,34,71,87,1
2034,0,0,0,0,0,0,0,,0,0,0,0,0,0,0,0
2035,46,25,16,22,8,22,34,64.7,12,23,8,15,27,73,66,0
2036,0,0,0,0,0,0,1,0,1,0,0,0,0,0,0,0
2037,2,0,1,0,1,0,9,0,9,3,1,2,2,4,0,0
2038,0,0,0,0,0,0,0,,0,0,0,0,0,0,2,0
2039,19,10,8,7,4,6,25,24,19,26,4,22,18,37,14,0
2040,0,0,0,0,0,0,0,,0,1,0,1,0,0,0,0
2041,3,2,2,1,0,2,3,66.7,1,2,0,2,2,5,0,0
2042,68,38,24,26,18,17,51,33.3,34,43,5,38,9,77,22,0
2043,0,0,0,0,0,0,0,,0,0,0,0,0,0,0,0
2044,1,0,0,0,1,0,0,,0,1,0,1,0,1,0,0
2045,23,13,9,11,3,12,24,50,12,10,6,4,10,33,5,2
2046,43,29,15,15,13,20,52,38.5,32,32,7,25,29,72,19,1
2047,35,19,25,5,5,13,31,41.9,18,30,10,20,22,57,42,0
2048,2,1,2,0,0,1,3,33.3,2,0,0,0,0,2,5,0
2049,43,29,22,17,4,18,44,40.9,26,22,4,18,23,66,35,2
2050,27,12,8,13,6,12,30,40,18,27,6,21,20,47,14,0
2051,13,9,8,4,1,6,12,50,6,5,1,4,4,17,7,0
2052,7,3,3,2,2,3,12,25,9,5,1,4,4,11,2,0
2053,21,15,17,4,0,9,20,45,11,22,11,11,12,33,44,2
2054,0,0,0,0,0,0,0,,0,1,0,1,0,0,10,3
2055,22,13,6,13,3,13,27,48.1,14,14,1,13,6,28,7,0
2056,21,12,16,5,0,14,20,70,6,18,12,6,39,60,88,0
2057,35,20,21,13,1,19,29,65.5,10,28,16,12,36,71,50,1
2058,23,16,8,13,2,8,12,66.7,4,5,3,2,9,32,15,0
2059,10,6,2,5,3,3,9,33.3,6,9,5,4,2,12,12,0
2060,16,8,4,10,2,7,31,22.6,24,9,0,9,9,25,3,0
2061,28,21,8,15,5,12,27,44.4,15,13,4,9,15,43,30,0
2062,34,16,17,12,5,10,28,35.7,18,12,3,9,31,65,32,0
2063,20,12,9,8,3,7,20,35,13,13,0,13,5,25,7,1
2064,36,23,8,19,9,16,47,34,31,18,2,16,6,42,8,0
2065,15,12,2,8,5,4,18,22.2,14,23,5,18,8,23,18,1
2066,58,30,38,14,6,26,57,45.6,31,25,7,18,25,83,92,2
2067,0,0,0,0,0,0,0,,0,0,0,0,0,0,0,1
2068,45,29,33,11,1,32,46,69.6,14,28,10,18,29,74,58,0
2069,1,1,0,1,0,0,4,0,4,0,0,0,0,1,5,0
2070,2,2,0,1,1,0,1,0,1,0,0,0,0,2,1,0
2071,35,14,10,17,8,16,60,26.7,44,29,1,28,27,62,20,0
2072,23,10,13,5,5,12,19,63.2,7,9,1,8,5,28,23,0
2073,9,5,4,3,2,1,10,10,9,13,2,11,6,15,7,0
2074,1,1,0,1,0,1,1,100,0,0,0,0,0,1,0,0
2075,20,8,8,10,2,10,29,34.5,19,12,3,9,16,36,24,0
2076,2,0,1,1,0,2,6,33.3,4,1,0,1,5,7,2,0
2077,0,0,0,0,0,0,0,,0,0,0,0,0,0,0,0
2078,8,5,3,5,0,3,9,33.3,6,9,1,8,8,16,2,0
2079,4,2,1,3,0,1,8,12.5,7,7,0,7,3,7,8,0
2080,19,9,7,9,3,6,20,30,14,15,1,14,9,28,4,0
2081,0,0,0,0,0,0,0,,0,0,0,0,0,0,0,0
2082,1,1,1,0,0,1,1,100,0,0,0,0,0,1,1,0
2083,33,17,10,20,3,14,28,50,14,19,10,9,37,70,29,1
2084,21,7,10,7,4,8,30,26.7,22,18,7,11,21,42,22,0
2085,37,20,19,13,5,21,40,52.5,19,13,1,12,17,54,39,0
2086,13,5,7,4,2,5,18,27.8,13,12,1,11,1,14,8,0
2087,65,35,33,25,7,36,52,69.2,16,26,12,14,43,108,64,1
2088,27,18,8,16,3,13,25,52,12,8,4,4,8,35,11,0
2089,18,12,7,6,5,7,23,30.4,16,26,5,21,12,30,11,0
2090,4,2,0,3,1,0,13,0,13,11,1,10,2,6,5,0
2091,8,3,3,1,4,3,12,25,9,10,0,10,2,10,2,0
2092,3,2,2,1,0,2,4,50,2,1,0,1,0,3,3,0
2093,0,0,0,0,0,0,1,0,1,0,0,0,0,0,1,1
2094,8,6,1,3,4,0,10,0,10,6,1,5,3,11,4,0
2095,4,1,2,1,1,3,10,30,7,2,0,2,3,7,4,0
2096,3,3,2,1,0,0,10,0,10,3,1,2,0,3,1,0
2097,44,21,21,21,2,16,25,64,9,27,9,18,21,65,47,0
2098,0,0,0,0,0,0,0,,0,0,0,0,0,0,3,0
2099,38,22,18,11,9,28,50,56,22,39,7,32,47,85,42,0
2100,,0,,,,,,,,,,,0,,,
2101,11,5,7,1,3,4,13,30.8,9,1,0,1,2,13,6,0
2102,34,22,18,14,2,16,29,55.2,13,24,6,18,17,51,42,0
2103,43,32,24,17,2,26,45,57.8,19,28,11,17,42,85,67,0
2104,0,0,0,0,0,0,0,,0,0,0,0,0,0,0,0
2105,0,0,0,0,0,0,0,,0,0,0,0,0,0,3,0
2106,27,14,10,11,6,14,33,42.4,19,22,3,19,13,40,7,0
2107,3,3,0,3,0,1,4,25,3,1,0,1,0,3,5,0
2108,5,3,2,3,0,1,13,7.7,12,7,0,7,2,7,17,0
2109,0,0,0,0,0,0,1,0,1,0,0,0,1,1,9,5
2110,31,17,23,8,0,21,29,72.4,8,33,17,16,22,53,86,0
2111,24,11,4,19,1,8,14,57.1,6,16,4,12,9,33,11,0
2112,14,5,6,7,1,7,23,30.4,16,7,0,7,3,17,5,0
2113,12,9,4,7,1,4,8,50,4,8,2,6,4,16,6,0
2114,21,9,16,5,0,16,29,55.2,13,29,18,11,39,60,106,0
2115,28,13,15,7,6,8,18,44.4,10,13,5,8,9,37,16,0
2116,0,0,0,0,0,0,0,,0,0,0,0,0,0,0,0
2117,15,11,6,7,2,5,21,23.8,16,12,1,11,4,19,5,0
2118,1,1,0,1,0,0,0,,0,0,0,0,0,1,0,0
2119,54,25,24,25,5,24,57,42.1,33,37,9,28,24,78,18,0
2120,0,0,0,0,0,0,0,,0,0,0,0,0,0,0,0
2121,0,0,0,0,0,0,0,,0,0,0,0,0,0,1,0
2122,5,4,1,1,3,2,3,66.7,1,6,0,6,2,7,8,0
2123,2,2,0,1,1,0,1,0,1,0,0,0,0,2,6,0
2124,9,4,5,3,1,3,8,37.5,5,5,1,4,2,11,3,0
2125,14,8,9,5,0,5,7,71.4,2,3,2,1,1,15,11,0
2126,1,1,0,1,0,0,0,,0,0,0,0,1,2,1,1
2127,2,0,0,0,2,0,2,0,2,1,0,1,0,2,0,0
2128,1,1,1,0,0,0,1,0,1,1,0,1,1,2,14,1
2129,0,0,0,0,0,0,0,,0,0,0,0,1,1,0,0
2130,58,29,38,19,1,32,51,62.7,19,37,23,14,50,108,132,1
2131,79,45,52,21,6,42,73,57.5,31,22,7,15,48,127,74,0
2132,28,15,15,11,2,17,28,60.7,11,18,7,11,10,38,38,0
2133,28,16,13,11,4,14,29,48.3,15,12,3,9,22,50,23,0
2134,11,6,0,7,4,2,18,11.1,16,24,3,21,7,18,23,0
2135,4,1,4,0,0,1,2,50,1,0,0,0,0,4,1,0
2136,51,35,37,12,2,25,38,65.8,13,30,11,19,44,95,154,1
2137,32,14,14,8,10,10,24,41.7,14,33,4,29,6,38,12,1
2138,0,0,0,0,0,0,0,,0,0,0,0,0,0,0,0
2139,0,0,0,0,0,0,0,,0,0,0,0,0,0,0,0
2140,22,12,18,4,0,11,14,78.6,3,19,16,3,34,56,86,1
2141,7,4,1,4,2,3,8,37.5,5,10,2,8,4,11,2,0
2142,25,11,18,6,1,15,27,55.6,12,18,3,15,17,42,52,0
2143,18,14,6,9,3,7,20,35,13,9,1,8,4,22,9,0
2144,48,30,17,20,11,21,40,52.5,19,32,3,29,25,73,38,0
2145,18,11,10,5,3,4,17,23.5,13,8,1,7,10,28,1,0
2146,2,0,1,1,0,1,4,25,3,2,0,2,1,3,3,0
2147,13,9,5,7,1,6,28,21.4,22,11,0,11,13,26,16,0
2148,0,0,0,0,0,0,0,,0,0,0,0,0,0,0,0
2149,24,12,8,11,5,15,54,27.8,39,11,2,9,13,37,5,0
2150,0,0,0,0,0,0,0,,0,0,0,0,1,1,1,0
2151,9,3,1,4,4,2,11,18.2,9,15,5,10,2,11,24,0
2152,5,4,1,3,1,3,10,30,7,5,0,5,1,6,7,0
2153,17,10,13,4,0,6,10,60,4,11,5,6,17,34,32,2
2154,26,18,4,20,2,7,21,33.3,14,10,1,9,6,32,11,0
2155,0,0,0,0,0,0,2,0,2,0,0,0,2,2,30,3
2156,46,28,9,26,11,14,34,41.2,20,26,2,24,17,63,22,0
2157,16,7,2,6,8,3,19,15.8,16,21,3,18,7,23,8,0
2158,48,30,20,26,2,22,39,56.4,17,43,18,25,28,76,71,2
2159,11,7,8,2,1,4,8,50,4,7,5,2,7,18,45,1
2160,13,4,3,6,4,3,13,23.1,10,13,0,13,3,16,9,0
2161,1,1,1,0,0,1,1,100,0,0,0,0,0,1,15,1
2162,2,0,1,0,1,0,5,0,5,7,1,6,1,3,1,0
2163,2,2,0,2,0,2,3,66.7,1,1,0,1,0,2,1,0
2164,19,10,6,8,5,8,22,36.4,14,12,1,11,3,22,4,0
2165,0,0,0,0,0,0,0,,0,0,0,0,0,0,0,0
2166,2,2,1,0,1,1,5,20,4,5,0,5,1,3,6,0
2167,47,28,14,27,6,14,29,48.3,15,18,3,15,47,94,19,0
2168,17,8,7,8,2,3,19,15.8,16,12,4,8,5,22,11,0
2169,0,0,0,0,0,0,0,,0,1,0,1,0,0,0,0
2170,59,26,23,31,5,23,60,38.3,37,28,3,25,39,98,33,0
2171,0,0,0,0,0,0,0,,0,0,0,0,0,0,0,0
2172,36,22,14,17,5,22,52,42.3,30,18,3,15,23,59,22,0
2173,0,0,0,0,0,0,0,,0,0,0,0,0,0,0,0
2174,0,0,0,0,0,0,1,0,1,0,0,0,2,2,10,2
2175,24,14,18,5,1,12,37,32.4,25,18,2,16,11,35,24,0
2176,12,6,10,2,0,4,8,50,4,7,2,5,4,16,8,2
2177,34,20,18,12,4,17,44,38.6,27,33,3,30,11,45,36,0
2178,6,3,2,4,0,2,14,14.3,12,5,0,5,3,9,0,0
2179,23,11,2,14,7,6,29,20.7,23,21,1,20,4,27,3,0
2180,6,6,4,2,0,4,9,44.4,5,5,1,4,5,11,2,1
2181,10,7,6,3,1,3,17,17.6,14,12,0,12,5,15,10,0
2182,1,0,1,0,0,1,2,50,1,1,0,1,0,1,0,0
2183,17,9,2,9,6,2,10,20,8,18,2,16,4,21,13,0
2184,0,0,0,0,0,0,1,0,1,0,0,0,0,0,0,0
2185,4,3,3,1,0,2,7,28.6,5,3,1,2,2,6,5,1
2186,0,0,0,0,0,0,0,,0,0,0,0,0,0,0,0
2187,6,2,2,2,2,2,15,13.3,13,14,1,13,3,9,12,0
2188,73,34,48,21,4,42,79,53.2,37,28,10,18,36,109,62,0
2189,1,0,0,1,0,1,2,50,1,2,0,2,0,1,2,0
2190,2,2,1,0,1,2,3,66.7,1,0,0,0,1,3,0,0
2191,64,43,32,24,8,15,34,44.1,19,34,8,26,20,84,41,1
2192,32,18,9,19,4,12,33,36.4,21,16,6,10,16,48,21,0
2193,25,8,9,13,3,8,20,40,12,16,9,7,22,47,16,2
2194,0,0,0,0,0,0,0,,0,0,0,0,0,0,0,0
2195,11,7,8,3,0,7,19,36.8,12,14,7,7,7,18,29,0
2196,0,0,0,0,0,0,0,,0,0,0,0,0,0,0,1
2197,9,6,3,6,0,5,9,55.6,4,7,2,5,5,14,15,0
2198,0,0,0,0,0,0,0,,0,0,0,0,0,0,0,0
2199,0,0,0,0,0,0,0,,0,0,0,0,0,0,0,0
2200,43,27,17,20,6,16,28,57.1,12,21,2,19,12,55,4,0
2201,14,8,3,9,2,7,11,63.6,4,3,0,3,4,18,0,0
2202,16,7,10,4,2,5,6,83.3,1,17,14,3,18,34,81,0
2203,0,0,0,0,0,0,1,0,1,1,0,1,0,0,1,0
2204,2,2,2,0,0,2,3,66.7,1,1,0,1,1,3,21,1
2205,0,0,0,0,0,0,1,0,1,3,0,3,1,1,0,0
2206,40,22,12,23,5,13,40,32.5,27,31,8,23,23,63,35,0
2207,0,0,0,0,0,0,0,,0,0,0,0,0,0,3,0
2208,4,2,2,2,0,2,3,66.7,1,4,1,3,3,7,9,0
2209,10,9,6,4,0,7,8,87.5,1,17,9,8,16,26,43,0
2210,7,3,1,3,3,1,12,8.3,11,14,3,11,2,9,3,0
2211,25,15,17,8,0,12,19,63.2,7,21,8,13,27,52,52,0
2212,12,5,6,6,0,8,15,53.3,7,4,2,2,8,20,27,0
2213,2,1,2,0,0,1,2,50,1,0,0,0,0,2,26,3
2214,0,0,0,0,0,0,0,,0,0,0,0,1,1,0,0
2215,67,44,31,28,8,30,69,43.5,39,36,7,29,24,91,28,0
2216,38,21,23,11,4,19,33,57.6,14,18,8,10,22,60,67,0
2217,8,4,5,1,2,1,3,33.3,2,4,3,1,4,12,16,0
2218,51,29,25,14,12,22,71,31,49,43,0,43,29,80,28,1
2219,12,9,4,8,0,5,7,71.4,2,10,1,9,3,15,1,0
2220,40,21,15,21,4,17,55,30.9,38,34,3,31,11,51,20,0
2221,6,5,1,4,1,2,13,15.4,11,10,1,9,5,11,5,1
2222,31,19,12,12,7,11,30,36.7,19,22,3,19,15,46,23,0
2223,29,18,5,15,9,11,38,28.9,27,29,3,26,9,38,11,0
2224,0,0,0,0,0,0,0,,0,0,0,0,0,0,0,0
2225,52,29,30,10,12,30,64,46.9,34,38,5,33,27,79,39,1
2226,0,0,0,0,0,0,0,,0,0,0,0,0,0,0,0
2227,0,0,0,0,0,0,0,,0,1,0,1,0,0,10,1
2228,14,8,3,6,5,7,20,35,13,14,0,14,3,17,3,1
2229,31,19,21,3,7,20,30,66.7,10,20,7,13,32,63,47,2
2230,2,0,2,0,0,1,1,100,0,0,0,0,2,4,2,0
2231,22,14,9,9,4,7,30,23.3,23,21,2,19,8,30,16,0
2232,40,24,15,18,7,22,43,51.2,21,20,8,12,31,71,45,1
2233,0,0,0,0,0,0,0,,0,0,0,0,1,1,6,2
2234,0,0,0,0,0,0,1,0,1,0,0,0,0,0,1,1
2235,5,3,4,1,0,4,5,80,1,2,0,2,0,5,0,1
2236,5,3,4,0,1,1,1,100,0,3,0,3,0,5,0,0
2237,11,8,4,6,1,2,9,22.2,7,11,6,5,9,20,19,0
2238,0,0,0,0,0,0,0,,0,0,0,0,1,1,24,2
2239,0,0,0,0,0,0,2,0,2,0,0,0,2,2,3,0
2240,0,0,0,0,0,0,0,,0,0,0,0,1,1,0,1
2241,45,30,13,21,11,16,42,38.1,26,23,6,17,12,57,41,1
2242,41,20,17,19,5,19,40,47.5,21,41,6,35,27,68,15,0
2243,7,4,2,4,1,3,9,33.3,6,6,0,6,1,8,3,0
2244,0,0,0,0,0,0,1,0,1,0,0,0,0,0,1,0
2245,15,6,9,5,1,11,34,32.4,23,14,2,12,7,22,3,0
2246,0,0,0,0,0,0,0,,0,0,0,0,0,0,0,0
2247,17,10,6,6,5,8,13,61.5,5,12,0,12,3,20,1,0
2248,8,4,4,2,2,2,5,40,3,7,1,6,14,22,9,0
2249,33,19,17,13,3,20,34,58.8,14,24,5,19,31,64,18,0
2250,80,42,45,32,3,38,71,53.5,33,45,21,24,63,143,52,1
2251,26,15,10,15,1,11,18,61.1,7,21,9,12,22,48,50,1
2252,0,0,0,0,0,0,0,,0,1,0,1,0,0,0,0
2253,19,12,11,5,3,11,16,68.8,5,7,1,6,4,23,7,0
2254,1,0,0,1,0,1,2,50,1,0,0,0,0,1,0,0
2255,40,23,18,15,7,15,31,48.4,16,42,4,38,12,52,34,0
2256,30,16,14,10,6,13,36,36.1,23,30,4,26,16,46,24,0
2257,41,20,19,17,5,22,45,48.9,23,29,4,25,30,71,54,0
2258,0,0,0,0,0,0,0,,0,0,0,0,0,0,5,2
2259,0,0,0,0,0,0,0,,0,0,0,0,0,0,1,0
2260,1,1,0,1,0,1,2,50,1,1,0,1,1,2,2,0
2261,1,0,1,0,0,1,4,25,3,0,0,0,1,2,12,3
2262,2,2,2,0,0,0,3,0,3,3,1,2,2,4,4,0
2263,22,13,9,10,3,13,34,38.2,21,15,2,13,18,40,11,0
2264,28,15,11,10,7,14,58,24.1,44,22,1,21,25,53,20,0
2265,38,21,18,15,5,18,50,36,32,21,1,20,19,57,21,1
2266,44,32,26,16,2,25,43,58.1,18,16,6,10,17,61,48,0
2267,22,15,10,10,2,10,27,37,17,10,2,8,13,35,26,0
2268,0,0,0,0,0,0,0,,0,0,0,0,0,0,0,0
2269,36,20,27,7,2,23,39,59,16,25,15,10,30,66,90,1
2270,5,1,2,3,0,3,5,60,2,2,0,2,4,9,6,0
2271,20,13,10,7,3,10,15,66.7,5,25,5,20,22,42,62,1
2272,0,0,0,0,0,0,0,,0,0,0,0,0,0,0,0
2273,16,7,6,7,3,9,16,56.3,7,11,1,10,5,21,11,0
2274,36,21,16,15,5,20,35,57.1,15,24,3,21,23,59,61,0
2275,9,7,2,4,3,2,8,25,6,6,0,6,6,15,4,0
2276,21,13,7,8,6,8,28,28.6,20,11,1,10,6,27,5,1
2277,0,0,0,0,0,0,0,,0,0,0,0,2,2,0,0
2278,36,20,24,11,1,15,24,62.5,9,38,27,11,28,64,110,3
2279,39,26,23,12,4,18,33,54.5,15,26,16,10,38,77,103,2
2280,15,7,5,8,2,5,17,29.4,12,11,1,10,13,28,8,0
2281,0,0,0,0,0,0,0,,0,2,1,1,0,0,7,0
2282,72,43,24,38,10,32,59,54.2,27,28,5,23,28,100,45,0
2283,20,9,7,6,7,4,32,12.5,28,12,0,12,11,31,27,1
2284,10,7,4,5,1,5,22,22.7,17,11,0,11,3,13,4,0
2285,12,9,2,6,4,1,17,5.9,16,8,1,7,0,12,2,0
2286,15,11,8,7,0,6,10,60,4,10,1,9,7,22,6,0
2287,15,9,6,7,2,4,21,19,17,15,1,14,3,18,13,0
2288,16,11,6,8,2,4,12,33.3,8,7,1,6,11,27,6,0
2289,4,3,1,3,0,2,3,66.7,1,2,0,2,5,9,7,1
2290,53,31,20,24,9,15,46,32.6,31,28,3,25,20,73,27,0
2291,97,53,46,45,6,54,98,55.1,44,55,12,43,31,128,56,0
2292,20,12,8,8,4,4,14,28.6,10,19,1,18,4,24,12,0
2293,36,21,11,23,2,18,33,54.5,15,22,8,14,41,77,48,1
2294,18,14,7,4,7,3,18,16.7,15,21,0,21,11,29,3,0
2295,23,12,19,2,2,14,32,43.8,18,14,5,9,16,39,29,0
2296,5,3,1,2,2,1,8,12.5,7,6,1,5,1,6,3,0
2297,21,13,12,5,4,15,22,68.2,7,20,8,12,18,39,42,1
2298,24,14,14,10,0,14,18,77.8,4,21,12,9,19,43,45,0
2299,28,12,14,12,2,15,20,75,5,34,28,6,9,37,86,0
2300,0,0,0,0,0,0,0,,0,0,0,0,0,0,2,0
2301,62,39,39,21,2,22,34,64.7,12,46,21,25,33,95,74,1
2302,2,2,0,2,0,0,0,,0,1,0,1,2,4,0,0
2303,2,1,0,1,1,0,2,0,2,0,0,0,1,3,0,0
2304,2,2,2,0,0,2,2,100,0,0,0,0,1,3,10,0
2305,77,39,25,45,7,28,73,38.4,45,39,8,31,51,128,43,0
2306,8,6,1,5,2,2,6,33.3,4,8,0,8,2,10,29,0
2307,1,0,0,1,0,1,1,100,0,0,0,0,0,1,0,0
2308,6,1,1,2,3,4,14,28.6,10,5,0,5,0,6,10,0
2309,77,51,36,36,5,28,60,46.7,32,26,5,21,33,110,14,0
2310,69,42,33,29,7,34,62,54.8,28,36,2,34,45,114,41,0
2311,0,0,0,0,0,0,0,,0,0,0,0,1,1,0,0
2312,59,37,18,32,9,26,66,39.4,40,33,7,26,38,97,43,0
2313,0,0,0,0,0,0,0,,0,0,0,0,0,0,0,0
2314,16,10,11,4,1,10,24,41.7,14,8,5,3,14,30,11,1
2315,0,0,0,0,0,0,0,,0,0,0,0,0,0,0,0
2316,4,3,2,2,0,3,6,50,3,2,0,2,2,6,3,0
2317,14,9,8,6,0,10,16,62.5,6,24,5,19,14,28,34,2
2318,37,26,16,14,7,15,40,37.5,25,21,1,20,20,57,20,0
2319,3,2,2,1,0,2,3,66.7,1,7,0,7,3,6,1,0
2320,21,11,15,5,1,15,19,78.9,4,36,25,11,19,40,89,0
2321,7,4,7,0,0,3,4,75,1,6,5,1,2,9,24,1
2322,6,1,4,2,0,4,7,57.1,3,0,0,0,2,8,4,0
2323,0,0,0,0,0,0,0,,0,0,0,0,0,0,3,0
2324,48,28,29,15,4,36,48,75,12,20,11,9,28,76,91,1
2325,22,12,9,13,0,11,21,52.4,10,8,3,5,11,33,8,1
2326,8,5,4,4,0,4,7,57.1,3,9,4,5,11,19,47,0
2327,8,4,5,2,1,7,10,70,3,6,1,5,2,10,25,0
2328,68,43,32,28,8,39,84,46.4,45,31,7,24,40,108,50,0
2329,21,15,13,3,5,10,34,29.4,24,8,0,8,8,29,6,0
2330,3,1,3,0,0,1,9,11.1,8,5,2,3,3,6,2,0
2331,55,33,22,29,4,29,67,43.3,38,34,1,33,22,77,32,0
2332,11,9,7,2,2,6,9,66.7,3,18,13,5,29,40,71,1
2333,0,0,0,0,0,0,4,0,4,0,0,0,1,1,15,5
2334,9,4,5,3,1,4,15,26.7,11,11,1,10,9,18,7,0
2335,1,0,1,0,0,0,1,0,1,0,0,0,0,1,1,0
2336,19,10,10,9,0,13,31,41.9,18,14,9,5,27,46,73,1
2337,18,13,4,8,6,6,17,35.3,11,29,1,28,6,24,11,1
2338,0,0,0,0,0,0,0,,0,0,0,0,0,0,2,0
2339,27,15,11,12,4,17,25,68,8,12,4,8,16,43,32,0
2340,0,0,0,0,0,0,0,,0,0,0,0,0,0,1,0
2341,2,1,2,0,0,2,4,50,2,0,0,0,2,4,19,5
2342,12,4,3,5,4,3,20,15,17,6,0,6,6,18,3,0
2343,12,10,11,0,1,7,13,53.8,6,11,4,7,13,25,16,1
2344,4,2,2,2,0,1,1,100,0,1,0,1,0,4,0,0
2345,6,3,3,2,1,3,9,33.3,6,5,1,4,3,9,12,0
2346,34,18,10,15,9,7,25,28,18,10,2,8,7,41,3,0
2347,18,7,8,8,2,9,19,47.4,10,7,0,7,9,27,10,1
2348,2,1,1,1,0,1,1,100,0,0,0,0,1,3,0,0
2349,15,10,14,1,0,13,16,81.3,3,11,7,4,4,19,18,2
2350,43,22,12,17,14,15,51,29.4,36,19,0,19,15,58,8,0
2351,4,3,1,2,1,3,4,75,1,2,0,2,0,4,0,0
2352,10,5,1,8,1,1,9,11.1,8,4,0,4,2,12,0,0
2353,13,8,6,4,3,3,17,17.6,14,13,2,11,11,24,3,0
2354,40,27,28,11,1,19,33,57.6,14,41,21,20,58,98,158,2
2355,40,21,12,17,11,13,39,33.3,26,28,2,26,22,62,23,0
2356,34,22,26,8,0,16,26,61.5,10,41,34,7,41,75,134,4
2357,0,0,0,0,0,0,1,0,1,3,1,2,0,0,0,0
2358,22,11,10,10,2,13,30,43.3,17,6,0,6,14,36,11,0
2359,17,8,5,9,3,6,19,31.6,13,7,1,6,6,23,5,0
2360,1,1,0,0,1,0,1,0,1,2,1,1,0,1,7,1
2361,54,32,36,16,2,27,35,77.1,8,24,16,8,48,102,85,0
2362,0,0,0,0,0,0,0,,0,0,0,0,0,0,0,0
2363,80,47,54,22,4,40,65,61.5,25,49,26,23,78,158,158,4
2364,22,16,8,11,3,7,23,30.4,16,12,0,12,11,33,12,0
2365,58,33,44,11,3,26,34,76.5,8,30,14,16,40,98,94,0
2366,20,10,9,8,3,8,20,40,12,17,2,15,6,26,11,0
2367,13,9,4,7,2,7,26,26.9,19,6,0,6,2,15,2,0
2368,41,26,14,21,6,21,44,47.7,23,27,11,16,28,69,26,0
2369,40,28,16,14,10,8,26,30.8,18,32,1,31,5,45,9,0
2370,22,18,11,9,2,12,14,85.7,2,12,7,5,13,35,12,4
2371,22,13,12,7,3,13,22,59.1,9,22,3,19,21,43,31,0
2372,0,0,0,0,0,0,0,,0,0,0,0,0,0,1,0
2373,16,5,5,8,3,5,15,33.3,10,5,0,5,8,24,6,0
2374,3,2,0,1,2,1,4,25,3,11,4,7,2,5,10,0
2375,12,7,2,8,2,5,20,25,15,2,0,2,5,17,13,0
2376,19,7,8,10,1,9,26,34.6,17,14,3,11,14,33,7,0
2377,9,8,0,6,3,2,11,18.2,9,4,0,4,2,11,3,0
2378,53,24,29,17,7,19,49,38.8,30,32,2,30,32,85,32,1
2379,41,22,25,14,2,19,28,67.9,9,24,16,8,30,71,54,3
2380,27,19,18,9,0,11,20,55,9,19,16,3,28,55,137,0
2381,,0,,,,,,,,,,,0,,,
2382,72,34,41,22,9,43,79,54.4,36,28,3,25,18,90,43,0
2383,2,1,2,0,0,1,1,100,0,1,0,1,0,2,11,4
2384,14,8,9,4,1,8,22,36.4,14,19,0,19,15,29,5,3
2385,0,0,0,0,0,0,0,,0,1,1,0,3,3,6,0
2386,27,16,15,9,3,11,25,44,14,17,6,11,27,54,40,0
2387,28,16,5,19,4,9,24,37.5,15,18,0,18,12,40,2,1
2388,10,6,3,7,0,2,19,10.5,17,8,3,5,1,11,9,0
2389,0,0,0,0,0,0,0,,0,0,0,0,0,0,0,0
2390,12,8,7,2,3,3,7,42.9,4,13,0,13,10,22,2,1
2391,13,7,5,6,2,3,15,20,12,1,0,1,4,17,2,0
2392,52,27,15,31,6,24,44,54.5,20,33,12,21,33,85,42,0
2393,0,0,0,0,0,0,1,0,1,0,0,0,1,1,1,0
2394,2,1,1,1,0,1,1,100,0,0,0,0,0,2,0,0
2395,2,2,1,1,0,0,2,0,2,1,0,1,0,2,1,0
2396,24,11,18,6,0,8,19,42.1,11,21,11,10,43,67,85,3
2397,36,16,22,13,1,15,25,60,10,21,7,14,42,78,62,0
2398,0,0,0,0,0,0,0,,0,0,0,0,0,0,0,0
2399,0,0,0,0,0,0,1,0,1,0,0,0,0,0,0,0
2400,10,2,1,6,3,6,16,37.5,10,5,0,5,1,11,3,0
2401,0,0,0,0,0,0,1,0,1,0,0,0,0,0,0,0
2402,8,5,6,1,1,2,4,50,2,3,0,3,4,12,7,1
2403,26,14,15,7,4,14,39,35.9,25,29,2,27,11,37,18,2
2404,1,1,0,0,1,0,2,0,2,2,0,2,0,1,0,0
2405,4,4,2,1,1,4,5,80,1,2,1,1,6,10,1,0
2406,12,7,4,3,5,5,19,26.3,14,10,1,9,9,21,10,0
2407,14,7,10,2,2,7,12,58.3,5,6,3,3,11,25,20,0
2408,6,3,5,0,1,3,4,75,1,3,0,3,2,8,10,0
2409,0,0,0,0,0,0,0,,0,0,0,0,0,0,0,0
2410,1,0,0,0,1,1,1,100,0,0,0,0,0,1,0,0
2411,5,2,1,1,3,2,7,28.6,5,8,0,8,2,7,3,0
2412,46,27,18,19,9,21,59,35.6,38,23,1,22,25,71,12,1
2413,18,11,11,7,0,9,15,60,6,20,12,8,16,34,69,0
2414,46,20,25,20,1,29,43,67.4,14,19,12,7,37,83,102,1
2415,40,30,21,14,5,17,41,41.5,24,27,4,23,22,62,38,0
2416,22,11,13,8,1,9,19,47.4,10,12,1,11,22,44,16,0
2417,19,14,2,5,12,5,21,23.8,16,16,1,15,5,24,22,1
2418,0,0,0,0,0,0,0,,0,0,0,0,0,0,0,0
2419,9,7,6,2,1,3,10,30,7,15,3,12,3,12,16,0
2420,4,1,3,1,0,0,5,0,5,7,1,6,2,6,4,0
2421,16,11,11,3,2,8,16,50,8,27,18,9,32,48,95,2
2422,16,10,7,7,2,11,20,55,9,17,3,14,3,19,3,0
2423,14,8,5,9,0,10,23,43.5,13,13,3,10,8,22,12,0
2424,5,2,2,2,1,1,9,11.1,8,6,1,5,3,8,28,0
2425,1,0,0,0,1,1,5,20,4,5,1,4,5,6,5,0
2426,43,20,20,20,3,20,49,40.8,29,25,2,23,9,52,14,0
2427,11,5,6,5,0,5,6,83.3,1,7,4,3,11,22,24,1
2428,72,43,36,34,2,33,48,68.8,15,41,32,9,56,128,154,1
2429,46,25,16,23,7,24,50,48,26,39,9,30,18,64,32,0
2430,0,0,0,0,0,0,2,0,2,0,0,0,1,1,15,2
2431,12,6,6,3,3,5,7,71.4,2,7,1,6,6,18,15,0
2432,57,37,21,27,9,42,86,48.8,44,44,8,36,39,96,39,0
2433,2,0,1,1,0,1,3,33.3,2,4,0,4,3,5,6,0
2434,21,12,9,11,1,6,13,46.2,7,8,2,6,20,41,18,0
2435,40,22,19,16,5,14,30,46.7,16,31,5,26,30,70,21,1
2436,25,17,10,12,3,9,22,40.9,13,22,5,17,33,58,29,1
2437,21,12,9,7,5,9,21,42.9,12,8,1,7,11,32,8,0
2438,0,0,0,0,0,0,0,,0,0,0,0,0,0,8,1
2439,0,0,0,0,0,0,1,0,1,0,0,0,2,2,18,3
2440,0,0,0,0,0,0,0,,0,0,0,0,0,0,0,0
2441,2,1,0,2,0,0,0,,0,0,0,0,0,2,0,0
2442,5,3,4,1,0,3,5,60,2,4,4,0,5,10,19,0
2443,50,31,15,32,3,26,56,46.4,30,27,3,24,19,69,30,1
2444,34,20,20,13,1,16,27,59.3,11,25,11,14,34,68,49,1
2445,5,4,1,3,1,1,3,33.3,2,6,1,5,1,6,11,0
2446,1,1,1,0,0,0,0,,0,0,0,0,1,2,22,0
2447,16,6,11,4,1,9,20,45,11,10,0,10,5,21,11,0
2448,58,39,39,17,2,25,49,51,24,23,4,19,21,79,64,1
2449,0,0,0,0,0,0,0,,0,0,0,0,0,0,0,0
2450,0,0,0,0,0,0,0,,0,0,0,0,0,0,0,0
2451,18,9,10,6,2,10,23,43.5,13,2,0,2,6,24,4,0
2452,4,3,1,3,0,2,4,50,2,2,0,2,0,4,2,0
2453,0,0,0,0,0,0,0,,0,0,0,0,1,1,3,0
2454,64,30,24,29,11,25,55,45.5,30,32,3,29,20,84,14,0
2455,1,0,1,0,0,1,2,50,1,0,0,0,0,1,1,0
2456,4,2,2,0,2,2,7,28.6,5,8,3,5,5,9,19,0
2457,3,1,0,3,0,2,4,50,2,0,0,0,3,6,2,0
2458,9,6,3,5,1,3,10,30,7,5,1,4,2,11,3,0
2459,2,2,2,0,0,0,0,,0,0,0,0,0,2,0,0
2460,25,19,14,7,4,11,22,50,11,18,3,15,7,32,26,0
2461,3,2,1,1,1,0,1,0,1,0,0,0,0,3,0,0
2462,18,12,8,8,2,6,17,35.3,11,12,6,6,14,32,11,0
2463,13,8,4,9,0,4,6,66.7,2,10,2,8,11,24,8,0
2464,27,16,19,7,1,13,25,52,12,11,7,4,8,35,12,1
2465,7,3,0,5,2,2,10,20,8,2,0,2,2,9,2,0
2466,21,13,9,9,3,12,21,57.1,9,22,11,11,9,30,22,2
2467,30,17,12,18,0,14,34,41.2,20,22,7,15,22,52,20,2
2468,2,1,1,1,0,0,1,0,1,1,0,1,3,5,1,0
2469,5,4,0,4,1,1,10,10,9,8,0,8,2,7,5,0
2470,0,0,0,0,0,0,0,,0,0,0,0,0,0,0,0
2471,0,0,0,0,0,0,0,,0,0,0,0,1,1,2,0
2472,0,0,0,0,0,0,0,,0,0,0,0,0,0,0,0
2473,1,1,1,0,0,0,0,,0,0,0,0,0,1,0,0
2474,24,13,13,8,3,9,24,37.5,15,10,1,9,16,40,13,0
2475,1,1,1,0,0,1,3,33.3,2,0,0,0,0,1,1,0
2476,7,3,7,0,0,5,8,62.5,3,7,2,5,6,13,35,0
2477,1,1,0,1,0,1,2,50,1,2,0,2,1,2,0,0
2478,7,3,3,4,0,3,6,50,3,1,0,1,2,9,7,1
2479,24,12,14,5,5,9,33,27.3,24,15,5,10,23,47,23,0
2480,13,9,2,3,8,4,13,30.8,9,20,2,18,2,15,15,0
2481,57,29,19,19,19,31,67,46.3,36,24,2,22,20,77,19,0
2482,53,30,31,18,4,28,59,47.5,31,30,6,24,27,80,37,3
2483,28,17,10,11,7,3,20,15,17,13,3,10,7,35,12,0
2484,3,2,0,2,1,0,8,0,8,2,0,2,1,4,1,0
2485,12,7,7,2,3,9,13,69.2,4,9,3,6,18,30,13,0
2486,10,8,4,4,2,7,12,58.3,5,4,0,4,3,13,7,0
2487,1,0,1,0,0,1,2,50,1,0,0,0,1,2,11,1
2488,32,21,19,12,1,11,22,50,11,54,31,23,44,76,100,0
2489,0,0,0,0,0,0,1,0,1,0,0,0,1,1,11,1
2490,48,27,25,21,2,27,41,65.9,14,22,11,11,40,88,46,1
2491,27,15,6,12,9,9,39,23.1,30,37,3,34,6,33,23,0
2492,0,0,0,0,0,0,0,,0,0,0,0,0,0,0,0
2493,0,0,0,0,0,0,0,,0,0,0,0,0,0,0,0
2494,0,0,0,0,0,0,0,,0,1,1,0,0,0,1,0
2495,17,11,6,5,6,11,23,47.8,12,14,3,11,12,29,5,0
2496,0,0,0,0,0,0,0,,0,0,0,0,1,1,5,1
2497,1,1,0,1,0,1,2,50,1,3,0,3,0,1,0,0
2498,55,35,24,24,7,24,34,70.6,10,26,6,20,23,78,47,0
2499,6,2,4,0,2,3,7,42.9,4,3,1,2,3,9,6,0
2500,0,0,0,0,0,0,0,,0,0,0,0,0,0,0,0
2501,0,0,0,0,0,0,0,,0,0,0,0,0,0,0,0
2502,1,1,1,0,0,1,2,50,1,0,0,0,0,1,19,2
2503,17,8,2,13,2,8,17,47.1,9,8,1,7,7,24,0,0
2504,47,23,18,20,9,19,46,41.3,27,32,11,21,35,82,31,0
2505,53,27,27,20,6,28,42,66.7,14,42,13,29,30,83,64,0
2506,2,0,2,0,0,1,1,100,0,0,0,0,0,2,2,0
2507,12,6,6,4,2,6,8,75,2,2,0,2,2,14,7,0
2508,0,0,0,0,0,0,1,0,1,0,0,0,0,0,0,0
2509,55,33,25,26,4,22,41,53.7,19,41,7,34,37,92,35,1
2510,33,19,14,18,1,15,31,48.4,16,19,7,12,12,45,10,1
2511,16,9,8,7,1,9,11,81.8,2,17,10,7,8,24,55,1
2512,0,0,0,0,0,0,1,0,1,0,0,0,0,0,17,0
2513,12,10,4,4,4,5,11,45.5,6,9,1,8,3,15,11,0
2514,3,2,1,1,1,2,9,22.2,7,2,0,2,3,6,3,0
2515,47,27,26,17,4,24,42,57.1,18,36,25,11,25,72,90,1
2516,3,2,0,1,2,1,6,16.7,5,4,0,4,2,5,5,0
2517,4,4,2,2,0,1,3,33.3,2,4,0,4,2,6,0,0
2518,36,23,28,8,0,18,25,72,7,32,24,8,26,62,92,1
2519,14,7,7,7,0,4,20,20,16,18,1,17,15,29,10,1
2520,38,26,23,9,6,16,25,64,9,18,7,11,16,54,31,1
2521,109,71,61,39,9,56,84,66.7,28,63,9,54,62,171,65,2
2522,1,1,1,0,0,1,1,100,0,1,0,1,2,3,0,0
2523,28,17,11,10,7,5,35,14.3,30,21,1,20,21,49,18,0
2524,1,1,1,0,0,1,3,33.3,2,1,0,1,2,3,3,0
2525,24,12,9,12,3,12,32,37.5,20,14,4,10,7,31,10,1
2526,3,1,0,1,2,1,3,33.3,2,4,0,4,1,4,7,0
2527,29,19,10,15,4,11,37,29.7,26,19,4,15,14,43,28,0
2528,0,0,0,0,0,0,2,0,2,0,0,0,3,3,8,3
2529,28,18,16,7,5,17,34,50,17,11,5,6,19,47,33,1
2530,20,9,8,10,2,11,16,68.8,5,10,2,8,5,25,9,1
2531,1,0,1,0,0,1,2,50,1,0,0,0,0,1,22,2
2532,57,30,27,22,8,17,56,30.4,39,37,3,34,22,79,32,0
2533,12,10,3,6,3,1,7,14.3,6,21,2,19,3,15,4,0
2534,22,12,14,5,3,12,26,46.2,14,30,3,27,26,48,61,0
2535,0,0,0,0,0,0,0,,0,0,0,0,0,0,0,0
2536,31,19,7,20,4,12,51,23.5,39,31,4,27,25,56,41,0
2537,9,4,4,4,1,3,9,33.3,6,3,0,3,1,10,2,0
2538,66,32,27,33,6,28,65,43.1,37,34,13,21,52,118,98,1
2539,0,0,0,0,0,0,1,0,1,0,0,0,0,0,0,0
2540,4,1,1,2,1,2,2,100,0,3,0,3,1,5,7,0
2541,15,5,5,8,2,4,9,44.4,5,22,16,6,34,49,95,0
2542,19,13,10,8,1,8,17,47.1,9,13,1,12,14,33,18,0
2543,56,35,30,17,9,32,65,49.2,33,21,7,14,34,90,60,1
2544,57,33,28,25,4,22,60,36.7,38,35,8,27,50,107,20,1
2545,28,17,21,6,1,16,21,76.2,5,15,5,10,23,51,34,0
2546,47,30,32,12,3,26,42,61.9,16,44,27,17,32,79,115,1
2547,0,0,0,0,0,0,1,0,1,4,1,3,0,0,3,0
2548,0,0,0,0,0,0,0,,0,0,0,0,0,0,2,0
2549,2,1,1,1,0,1,4,25,3,0,0,0,0,2,2,0
2550,13,9,7,6,0,7,8,87.5,1,7,3,4,14,27,14,0
2551,28,19,14,13,1,15,38,39.5,23,24,5,19,51,79,25,0
2552,37,27,22,13,2,20,26,76.9,6,19,6,13,31,68,43,0
2553,1,0,0,1,0,0,0,,0,0,0,0,0,1,0,0
2554,21,10,7,12,2,12,18,66.7,6,7,0,7,11,32,10,2
2555,28,16,18,10,0,12,17,70.6,5,27,17,10,36,64,122,2
2556,0,0,0,0,0,0,0,,0,0,0,0,0,0,0,0
2557,0,0,0,0,0,0,0,,0,0,0,0,0,0,0,0
2558,20,16,10,10,0,9,16,56.3,7,7,0,7,13,33,14,0
2559,0,0,0,0,0,0,0,,0,0,0,0,0,0,2,0
2560,16,7,6,9,1,7,20,35,13,10,0,10,8,24,6,0
2561,24,11,15,5,4,17,33,51.5,16,13,3,10,11,35,25,0
2562,4,1,0,3,1,3,8,37.5,5,4,1,3,1,5,1,0
2563,19,12,13,5,1,6,16,37.5,10,12,7,5,19,38,42,0
2564,23,10,3,11,9,10,23,43.5,13,12,0,12,12,35,3,0
2565,3,1,0,3,0,1,1,100,0,0,0,0,0,3,0,0
2566,30,17,11,15,4,9,23,39.1,14,32,6,26,9,39,16,2
2567,23,15,6,14,3,9,33,27.3,24,28,2,26,10,33,14,0
2568,1,1,1,0,0,1,1,100,0,2,2,0,0,1,6,0
2569,10,5,5,5,0,4,10,40,6,6,0,6,5,15,1,1
2570,96,63,55,32,9,59,114,51.8,55,39,13,26,27,123,65,1
2571,5,3,3,2,0,2,3,66.7,1,3,3,0,11,16,27,1
2572,0,0,0,0,0,0,0,,0,0,0,0,0,0,7,2
2573,13,8,10,3,0,8,11,72.7,3,15,13,2,9,22,49,0
2574,4,4,1,2,1,2,9,22.2,7,8,1,7,2,6,1,0
2575,8,3,3,5,0,3,11,27.3,8,7,2,5,7,15,3,0
2576,8,4,2,4,2,5,12,41.7,7,11,2,9,10,18,15,0
2577,61,39,34,23,4,30,50,60,20,35,23,12,33,94,60,2
2578,5,2,3,1,1,2,3,66.7,1,2,0,2,4,9,17,0
2579,13,6,5,6,2,7,19,36.8,12,6,2,4,8,21,15,0
2580,43,26,16,16,11,22,48,45.8,26,25,1,24,15,58,29,2
2581,74,47,34,30,10,42,91,46.2,49,46,5,41,31,105,30,0
2582,61,29,20,33,8,25,82,30.5,57,32,4,28,16,77,11,0
2583,8,5,2,4,2,2,10,20,8,8,1,7,1,9,14,0
2584,9,4,7,2,0,3,9,33.3,6,6,4,2,7,16,37,1
2585,5,2,0,3,2,1,5,20,4,2,0,2,2,7,6,0
2586,29,23,21,7,1,18,24,75,6,16,12,4,28,57,49,0
2587,23,12,7,9,7,10,17,58.8,7,10,1,9,4,27,5,0
2588,5,3,1,1,3,2,3,66.7,1,2,0,2,2,7,0,0
2589,0,0,0,0,0,0,1,0,1,0,0,0,0,0,0,0
2590,4,3,1,3,0,3,13,23.1,10,4,0,4,0,4,0,0
2591,20,13,11,6,3,8,16,50,8,10,5,5,17,37,39,0
2592,39,15,15,16,8,16,54,29.6,38,31,9,22,28,67,34,0
2593,33,17,26,6,1,18,32,56.3,14,27,15,12,10,43,61,5
2594,4,4,2,1,1,2,4,50,2,5,3,2,1,5,3,0
2595,2,2,0,1,1,0,1,0,1,0,0,0,1,3,5,0
2596,1,1,1,0,0,0,1,0,1,2,0,2,4,5,3,0
2597,3,2,0,2,1,0,2,0,2,2,0,2,0,3,0,0
2598,1,1,1,0,0,1,2,50,1,0,0,0,0,1,8,1
2599,17,12,5,9,3,8,27,29.6,19,30,3,27,10,27,15,0
2600,22,11,6,14,2,10,20,50,10,7,3,4,10,32,19,0
2601,20,7,4,10,6,7,17,41.2,10,14,1,13,4,24,15,0
2602,6,3,3,3,0,5,7,71.4,2,4,3,1,1,7,9,0
2603,25,18,19,5,1,17,33,51.5,16,31,20,11,43,68,156,0
2604,8,7,4,4,0,2,4,50,2,0,0,0,1,9,1,0
2605,28,19,13,9,6,13,40,32.5,27,15,4,11,19,47,13,1
2606,52,29,24,21,7,20,59,33.9,39,40,5,35,52,104,41,0
2607,14,8,7,6,1,9,19,47.4,10,13,5,8,9,23,31,0
2608,50,31,15,31,4,20,50,40,30,21,5,16,28,78,43,0
2609,35,17,24,10,1,20,32,62.5,12,27,15,12,29,64,72,1
2610,58,25,31,21,6,31,71,43.7,40,31,9,22,42,100,38,0
2611,34,18,28,5,1,24,45,53.3,21,16,9,7,23,57,35,0
2612,41,26,26,14,1,24,37,64.9,13,15,4,11,25,66,39,1
2613,0,0,0,0,0,0,0,,0,0,0,0,0,0,0,0
2614,65,45,47,17,1,33,47,70.2,14,75,61,14,48,113,186,4
2615,0,0,0,0,0,0,1,0,1,0,0,0,0,0,2,1
2616,16,9,9,7,0,9,14,64.3,5,6,2,4,9,25,14,0
2617,21,14,10,7,4,8,18,44.4,10,15,5,10,9,30,33,1
2618,45,26,31,11,3,26,44,59.1,18,42,20,22,58,103,95,2
2619,3,1,1,2,0,1,5,20,4,0,0,0,2,5,0,0
2620,1,1,0,1,0,0,1,0,1,2,1,1,2,3,2,0
2621,86,45,33,49,4,29,55,52.7,26,39,7,32,101,187,34,0
2622,2,1,1,1,0,0,0,,0,0,0,0,1,3,2,0
2623,5,5,0,3,2,1,4,25,3,3,0,3,0,5,1,0
2624,13,9,5,7,1,6,17,35.3,11,13,0,13,6,19,9,0
2625,48,27,35,9,4,27,43,62.8,16,17,4,13,26,74,45,0
2626,17,11,6,7,4,13,31,41.9,18,9,0,9,10,27,6,0
2627,42,27,30,9,3,24,37,64.9,13,10,2,8,26,68,42,0
2628,1,1,1,0,0,1,1,100,0,1,0,1,0,1,0,1
2629,0,0,0,0,0,0,1,0,1,0,0,0,1,1,13,5
2630,0,0,0,0,0,0,0,,0,0,0,0,0,0,1,0
2631,0,0,0,0,0,0,4,0,4,0,0,0,2,2,20,1
2632,55,33,22,16,17,25,43,58.1,18,29,3,26,18,73,17,0
2633,8,5,3,3,2,4,7,57.1,3,7,0,7,4,12,5,0
2634,6,4,4,1,1,5,7,71.4,2,6,2,4,5,11,5,1
2635,11,5,4,6,1,5,14,35.7,9,19,9,10,5,16,22,0
2636,10,5,4,5,1,3,13,23.1,10,4,0,4,3,13,1,0
2637,3,2,3,0,0,2,6,33.3,4,1,0,1,0,3,0,0
2638,33,19,26,3,4,14,31,45.2,17,29,16,13,42,75,69,0
2639,24,16,6,12,6,8,23,34.8,15,23,2,21,10,34,11,0
2640,0,0,0,0,0,0,0,,0,0,0,0,0,0,0,0
2641,13,8,5,8,0,6,14,42.9,8,9,0,9,10,23,8,0
2642,50,31,33,13,4,28,65,43.1,37,35,14,21,40,90,55,0
2643,49,37,28,21,0,30,57,52.6,27,35,19,16,44,93,126,0
2644,64,31,18,27,19,30,93,32.3,63,56,4,52,29,93,16,1
2645,2,0,0,2,0,1,2,50,1,3,0,3,4,6,0,0
2646,1,0,1,0,0,0,1,0,1,2,2,0,2,3,3,0
2647,46,26,15,23,8,28,56,50,28,37,12,25,25,71,39,0
2648,21,12,17,4,0,8,15,53.3,7,9,7,2,9,30,30,0
2649,6,5,0,5,1,1,4,25,3,5,0,5,5,11,5,0
2650,33,19,11,18,4,17,35,48.6,18,31,11,20,28,61,19,0
2651,7,3,1,3,3,3,4,75,1,4,0,4,3,10,2,0
2652,6,3,1,4,1,2,2,100,0,1,0,1,0,6,1,0
2653,74,38,23,45,6,42,100,42,58,47,13,34,21,95,41,3
2654,18,14,11,7,0,10,11,90.9,1,23,5,18,15,33,54,0
2655,4,3,1,2,1,2,3,66.7,1,3,1,2,0,4,3,0
2656,2,1,0,1,1,0,1,0,1,5,1,4,2,4,1,0
2657,43,26,17,18,8,19,42,45.2,23,33,4,29,12,55,26,0
2658,1,1,1,0,0,0,3,0,3,3,2,1,1,2,4,1
2659,0,0,0,0,0,0,0,,0,0,0,0,0,0,1,0
2660,59,37,43,15,1,39,60,65,21,45,21,24,51,110,130,2
2661,0,0,0,0,0,0,0,,0,0,0,0,0,0,0,0
2662,13,7,4,6,3,4,21,19,17,26,0,26,20,33,5,0
2663,11,5,1,9,1,7,17,41.2,10,5,1,4,9,20,10,0
2664,18,10,12,4,2,13,20,65,7,12,5,7,12,30,41,0
2665,38,15,12,15,11,24,39,61.5,15,23,11,12,26,64,35,0
2666,15,11,6,7,2,6,17,35.3,11,12,3,9,6,21,42,1
2667,8,4,0,7,1,0,6,0,6,3,0,3,4,12,1,0
2668,35,17,19,13,3,21,32,65.6,11,22,3,19,24,59,64,2
2669,0,0,0,0,0,0,0,,0,1,0,1,1,1,0,0
2670,8,3,6,2,0,6,8,75,2,8,8,0,4,12,18,0
2671,73,44,36,34,3,18,26,69.2,8,37,23,14,45,118,84,1
2672,54,37,23,25,6,21,41,51.2,20,26,8,18,34,88,19,0
2673,17,9,11,4,2,6,13,46.2,7,14,8,6,19,36,28,2
2674,33,21,5,20,8,12,38,31.6,26,16,2,14,14,47,44,1
2675,2,1,1,0,1,1,2,50,1,0,0,0,0,2,1,0
2676,37,29,13,21,3,18,40,45,22,18,1,17,26,63,18,0
2677,31,21,18,11,2,16,29,55.2,13,14,9,5,12,43,69,0
2678,2,2,0,1,1,0,3,0,3,2,0,2,0,2,1,0
2679,10,5,3,4,3,3,7,42.9,4,12,3,9,6,16,7,0
2680,22,12,8,7,7,8,25,32,17,10,1,9,6,28,4,0
2681,32,19,23,7,2,18,25,72,7,32,23,9,19,51,105,2
2682,7,4,3,1,3,3,15,20,12,8,0,8,8,15,4,0
2683,71,40,25,38,8,29,57,50.9,28,32,11,21,47,118,55,0
2684,4,1,1,3,0,4,5,80,1,4,2,2,17,21,30,0
2685,0,0,0,0,0,0,0,,0,0,0,0,0,0,0,0
2686,12,4,3,8,1,5,11,45.5,6,6,1,5,4,16,6,0
2687,12,9,8,3,1,4,17,23.5,13,10,3,7,5,17,19,0
2688,42,25,15,22,5,10,34,29.4,24,30,6,24,35,77,55,0
2689,5,2,1,3,1,1,3,33.3,2,3,1,2,3,8,8,0
2690,31,17,15,6,10,15,40,37.5,25,28,2,26,14,45,6,1
2691,8,3,6,0,2,3,7,42.9,4,4,1,3,2,10,1,0
2692,4,2,0,3,1,3,5,60,2,2,0,2,4,8,3,1
2693,0,0,0,0,0,0,0,,0,0,0,0,0,0,0,0
2694,3,3,0,1,2,1,2,50,1,0,0,0,0,3,1,0
2695,43,26,18,23,2,10,39,25.6,29,29,5,24,25,68,11,1
2696,16,12,10,4,2,2,13,15.4,11,11,4,7,15,31,30,0
2697,63,36,25,26,12,41,59,69.5,18,29,8,21,37,100,81,1
2698,28,17,16,11,1,13,28,46.4,15,25,17,8,44,72,122,1
2699,0,0,0,0,0,0,1,0,1,0,0,0,1,1,13,2
2700,25,18,16,8,1,12,22,54.5,10,13,4,9,23,48,17,0
2701,42,24,14,18,10,15,50,30,35,26,1,25,13,55,11,0
2702,0,0,0,0,0,0,0,,0,0,0,0,0,0,0,0
2703,45,25,16,18,11,23,66,34.8,43,19,3,16,13,58,17,0
2704,2,1,2,0,0,2,2,100,0,0,0,0,2,4,0,0
2705,49,30,25,19,5,26,45,57.8,19,20,3,17,34,83,75,0
2706,28,15,9,13,6,3,19,15.8,16,17,1,16,12,40,1,1
2707,17,10,8,8,1,10,16,62.5,6,10,3,7,10,27,10,0
2708,22,12,12,5,5,12,21,57.1,9,12,1,11,10,32,11,0
2709,18,9,11,6,1,10,15,66.7,5,24,14,10,7,25,82,1
2710,34,20,12,9,13,4,31,12.9,27,33,4,29,15,49,10,0
2711,29,21,17,9,3,11,24,45.8,13,25,5,20,19,48,30,0
2712,0,0,0,0,0,0,0,,0,0,0,0,0,0,0,0
2713,27,12,12,8,7,12,16,75,4,6,2,4,10,37,22,2
2714,5,3,3,2,0,2,5,40,3,5,4,1,5,10,12,1
2715,0,0,0,0,0,0,0,,0,1,1,0,0,0,0,0
2716,3,2,1,1,1,1,5,20,4,2,0,2,2,5,4,0
2717,0,0,0,0,0,0,4,0,4,1,0,1,2,2,2,0
2718,46,28,20,22,4,26,47,55.3,21,43,15,28,41,87,76,1
2719,5,3,3,1,1,2,9,22.2,7,3,0,3,1,6,1,0
2720,64,40,30,27,7,33,60,55,27,39,6,33,27,91,42,0
2721,23,14,11,10,2,12,18,66.7,6,20,7,13,31,54,29,1
2722,3,1,0,1,2,0,1,0,1,4,1,3,2,5,1,0
2723,13,9,5,5,3,9,19,47.4,10,7,2,5,4,17,2,0
2724,10,4,4,4,2,4,13,30.8,9,9,1,8,5,15,18,0
2725,0,0,0,0,0,0,0,,0,0,0,0,0,0,0,0
2726,0,0,0,0,0,0,1,0,1,4,0,4,2,2,7,0
2727,0,0,0,0,0,0,0,,0,0,0,0,0,0,1,0
2728,2,2,2,0,0,1,2,50,1,1,1,0,0,2,4,0
2729,37,22,2,18,17,5,42,11.9,37,25,5,20,5,42,36,0
2730,18,13,5,6,7,5,18,27.8,13,13,2,11,14,32,9,0
2731,66,42,42,21,3,24,36,66.7,12,20,10,10,32,98,71,6
2732,0,0,0,0,0,0,0,,0,0,0,0,0,0,2,2
2733,3,2,1,2,0,2,2,100,0,2,0,2,0,3,0,0
2734,28,15,15,10,3,14,24,58.3,10,12,3,9,16,44,21,0
2735,32,20,9,14,9,15,49,30.6,34,27,1,26,14,46,13,0
2736,7,4,6,1,0,0,2,0,2,13,1,12,10,17,7,0
2737,36,20,24,10,2,14,36,38.9,22,16,8,8,20,56,16,0
2738,1,1,1,0,0,1,2,50,1,0,0,0,0,1,1,0
2739,102,53,46,51,5,44,105,41.9,61,56,10,46,39,141,43,0
2740,3,2,3,0,0,1,1,100,0,0,0,0,0,3,1,0
2741,8,6,4,3,1,4,9,44.4,5,6,3,3,6,14,19,1
2742,31,19,18,12,1,13,24,54.2,11,34,26,8,31,62,173,1
2743,7,5,7,0,0,5,6,83.3,1,9,8,1,6,13,16,0
2744,8,2,1,4,3,4,13,30.8,9,7,0,7,0,8,4,0
2745,2,1,1,1,0,0,1,0,1,0,0,0,0,2,1,0
2746,36,16,11,16,9,12,31,38.7,19,23,5,18,24,60,12,0
2747,16,10,11,5,0,11,16,68.8,5,21,14,7,31,47,109,0
2748,35,19,10,19,6,15,23,65.2,8,17,4,13,13,48,12,0
2749,18,6,12,5,1,8,14,57.1,6,19,14,5,23,41,42,0
2750,0,0,0,0,0,0,0,,0,0,0,0,0,0,0,0
2751,28,19,21,6,1,10,22,45.5,12,18,9,9,18,46,82,1
2752,6,5,0,4,2,1,7,14.3,6,9,0,9,1,7,17,0
2753,28,21,7,14,7,11,30,36.7,19,9,1,8,16,44,13,0
2754,31,17,12,15,4,15,42,35.7,27,15,2,13,25,56,31,1
2755,79,46,44,32,3,48,75,64,27,32,10,22,42,121,85,0
2756,0,0,0,0,0,0,0,,0,0,0,0,0,0,0,0
2757,46,27,10,31,5,16,41,39,25,24,5,19,38,84,30,0
2758,24,13,10,8,6,10,22,45.5,12,16,3,13,9,33,19,0
2759,34,24,12,13,9,14,28,50,14,20,7,13,36,70,34,0
2760,43,22,24,9,10,17,35,48.6,18,25,7,18,20,63,41,1
2761,7,5,2,3,2,3,9,33.3,6,10,1,9,4,11,7,0
2762,5,4,0,4,1,3,12,25,9,2,0,2,4,9,1,0
2763,23,15,4,17,2,10,16,62.5,6,18,5,13,11,34,18,1
2764,74,48,47,21,6,21,53,39.6,32,46,16,30,45,119,89,0
2765,4,4,3,1,0,0,1,0,1,4,1,3,2,6,8,0
2766,26,11,11,9,6,8,42,19,34,31,13,18,19,45,22,0
2767,25,10,13,10,2,14,24,58.3,10,13,4,9,5,30,27,0
2768,11,4,8,2,1,9,20,45,11,17,2,15,18,29,8,0
2769,1,1,0,1,0,0,0,,0,0,0,0,0,1,0,0
2770,12,8,5,2,5,9,20,45,11,4,0,4,3,15,1,0
2771,19,9,15,4,0,8,16,50,8,20,14,6,13,32,59,1
2772,34,25,20,12,2,15,39,38.5,24,12,1,11,27,61,22,1
2773,2,2,2,0,0,0,0,,0,2,2,0,0,2,2,0
2774,0,0,0,0,0,0,0,,0,1,0,1,0,0,0,0
2775,60,40,16,30,14,32,64,50,32,36,10,26,18,78,14,2
2776,7,5,1,4,2,4,9,44.4,5,7,0,7,0,7,5,0
2777,4,2,3,1,0,2,7,28.6,5,2,0,2,1,5,0,0
2778,7,2,4,3,0,5,6,83.3,1,10,5,5,4,11,19,0
2779,27,14,7,18,2,11,31,35.5,20,16,5,11,20,47,34,2
2780,15,10,12,3,0,8,15,53.3,7,10,8,2,7,22,36,0
2781,41,29,28,12,1,26,41,63.4,15,41,25,16,36,77,105,1
2782,1,1,1,0,0,1,1,100,0,1,0,1,1,2,21,1
2783,31,25,17,9,5,19,39,48.7,20,19,6,13,25,56,35,2
2784,26,10,16,9,1,9,26,34.6,17,13,5,8,7,33,7,1
2785,83,47,49,25,9,39,77,50.6,38,32,14,18,58,141,79,0
2786,0,0,0,0,0,0,0,,0,0,0,0,0,0,0,0
2787,,6,,,,,,,,,,,5,,,
2788,32,23,25,7,0,24,34,70.6,10,31,22,9,37,69,119,1
2789,1,1,0,1,0,0,3,0,3,0,0,0,1,2,1,0
2790,12,7,5,7,0,6,13,46.2,7,2,0,2,2,14,5,0
2791,7,5,2,5,0,4,9,44.4,5,2,1,1,3,10,8,0
2792,16,6,7,8,1,7,21,33.3,14,10,2,8,8,24,17,0
2793,0,0,0,0,0,0,0,,0,0,0,0,0,0,1,0
2794,4,3,2,1,1,1,2,50,1,3,1,2,1,5,7,0
2795,5,3,4,1,0,2,5,40,3,4,1,3,1,6,1,0
2796,46,30,27,14,5,29,59,49.2,30,26,3,23,25,71,33,0
2797,2,2,1,1,0,1,2,50,1,1,1,0,0,2,1,0
2798,28,16,16,9,3,15,24,62.5,9,28,25,3,29,57,69,1
2799,3,2,1,1,1,2,5,40,3,3,0,3,1,4,1,0
2800,32,21,24,7,1,17,24,70.8,7,20,15,5,26,58,107,1
2801,5,0,0,2,3,2,11,18.2,9,6,2,4,1,6,16,0
2802,0,0,0,0,0,0,4,0,4,3,0,3,0,0,7,0
2803,11,7,4,6,1,5,20,25,15,4,0,4,2,13,1,0
2804,14,9,8,3,3,6,14,42.9,8,9,2,7,2,16,7,0
2805,21,12,15,6,0,11,21,52.4,10,18,7,11,13,34,101,1
2806,38,23,23,11,4,20,36,55.6,16,27,8,19,20,58,51,0
2807,24,10,2,18,4,6,31,19.4,25,20,0,20,3,27,9,0
2808,1,1,0,0,1,1,1,100,0,0,0,0,0,1,0,0
2809,34,13,14,16,4,14,26,53.8,12,19,7,12,13,47,16,0
2810,38,29,22,16,0,12,17,70.6,5,17,8,9,32,70,52,0
2811,27,17,14,12,1,12,20,60,8,10,1,9,12,39,30,0
2812,3,2,2,1,0,0,1,0,1,2,0,2,2,5,1,0
2813,12,7,3,4,5,3,7,42.9,4,5,1,4,0,12,9,0
2814,83,49,37,38,8,50,113,44.2,63,51,5,46,54,137,32,1
2815,4,2,2,0,2,1,5,20,4,3,0,3,5,9,2,0
2816,9,1,3,5,1,5,13,38.5,8,5,0,5,8,17,3,0
2817,15,6,7,7,1,8,17,47.1,9,14,4,10,14,29,16,1
2818,57,33,28,21,8,26,38,68.4,12,29,8,21,37,94,53,1
2819,9,5,7,2,0,3,5,60,2,5,2,3,7,16,14,0
2820,49,36,25,18,6,14,20,70,6,24,14,10,34,83,41,2
2821,2,2,0,2,0,1,1,100,0,0,0,0,0,2,0,0
2822,0,0,0,0,0,0,0,,0,0,0,0,0,0,1,0
2823,44,26,30,11,3,30,57,52.6,27,24,11,13,32,76,107,1
2824,41,24,12,24,5,19,70,27.1,51,43,15,28,40,81,45,1
2825,1,1,0,1,0,0,0,,0,2,0,2,0,1,0,0
2826,0,0,0,0,0,0,0,,0,0,0,0,0,0,3,0
2827,23,13,6,14,3,8,31,25.8,23,13,2,11,13,36,19,0
2828,17,13,2,7,8,2,15,13.3,13,25,3,22,12,29,27,0
2829,19,7,8,8,3,10,20,50,10,16,1,15,10,29,7,0
2830,26,8,17,7,2,13,20,65,7,25,17,8,17,43,66,2
2831,17,9,3,9,5,6,19,31.6,13,16,5,11,6,23,13,0
2832,13,7,3,3,7,7,17,41.2,10,10,3,7,2,15,11,1
2833,1,1,1,0,0,1,2,50,1,2,0,2,1,2,1,1
2834,14,7,2,8,4,3,10,30,7,18,2,16,5,19,18,0
2835,8,4,3,3,2,2,20,10,18,9,0,9,2,10,4,0
2836,21,12,8,12,1,10,31,32.3,21,21,9,12,30,51,16,1
2837,44,23,30,8,6,28,45,62.2,17,42,24,18,42,86,102,0
2838,60,28,32,20,8,36,61,59,25,44,16,28,43,103,59,2
2839,15,9,2,12,1,11,19,57.9,8,13,3,10,9,24,7,0
2840,30,15,18,10,2,15,26,57.7,11,15,3,12,14,44,42,0
2841,55,37,35,18,2,36,64,56.3,28,26,6,20,44,99,50,0
2842,14,5,1,6,7,5,17,29.4,12,18,3,15,3,17,20,0
2843,0,0,0,0,0,0,0,,0,0,0,0,0,0,0,0
2844,20,10,6,11,3,10,31,32.3,21,18,2,16,5,25,9,0
2845,64,37,30,28,6,29,68,42.6,39,37,6,31,21,85,10,1
2846,9,8,1,5,3,1,4,25,3,7,2,5,3,12,10,0
2847,53,31,13,31,9,22,61,36.1,39,30,1,29,27,80,13,0
2848,10,6,1,7,2,1,4,25,3,8,3,5,6,16,13,0
2849,0,0,0,0,0,0,0,,0,0,0,0,0,0,0,0
2850,15,10,4,9,2,8,21,38.1,13,14,3,11,16,31,10,2
2851,7,2,7,0,0,5,6,83.3,1,4,1,3,8,15,21,0
2852,25,10,6,16,3,10,28,35.7,18,12,1,11,13,38,4,0
2853,12,6,5,4,3,1,16,6.3,15,12,5,7,8,20,6,0
2854,42,27,12,23,7,18,30,60,12,24,9,15,27,69,38,0
2855,23,12,4,13,6,10,20,50,10,10,0,10,2,25,1,0
2856,26,10,13,9,4,12,24,50,12,14,1,13,13,39,8,0
2857,1,1,0,1,0,0,1,0,1,0,0,0,0,1,0,0
2858,15,9,6,7,2,5,15,33.3,10,8,1,7,7,22,11,0
2859,7,5,0,3,4,3,10,30,7,13,4,9,0,7,3,0
2860,2,0,1,1,0,1,2,50,1,5,2,3,2,4,9,0
2861,0,0,0,0,0,0,0,,0,0,0,0,0,0,0,1
2862,29,11,20,8,1,11,18,61.1,7,21,14,7,21,50,40,1
2863,0,0,0,0,0,0,0,,0,0,0,0,0,0,0,0
2864,47,27,18,24,5,27,56,48.2,29,23,3,20,24,71,26,1
2865,32,18,16,12,4,16,41,39,25,21,6,15,21,53,31,0
2866,0,0,0,0,0,0,1,0,1,0,0,0,0,0,1,0
2867,4,2,2,2,0,2,8,25,6,4,2,2,0,4,2,0
2868,10,5,3,6,1,1,9,11.1,8,4,0,4,2,12,1,0
2869,14,7,5,7,2,9,19,47.4,10,22,1,21,1,15,7,0
2870,1,0,0,1,0,1,1,100,0,1,0,1,0,1,0,0
2871,7,2,0,2,5,2,17,11.8,15,8,1,7,2,9,11,0
2872,9,8,6,2,1,5,5,100,0,7,5,2,5,14,17,0
2873,4,1,2,1,1,2,3,66.7,1,2,1,1,2,6,6,0
2874,1,0,0,1,0,0,0,,0,1,0,1,0,1,0,0
2875,17,10,8,9,0,8,15,53.3,7,27,20,7,28,45,72,1
2876,18,6,9,6,3,11,16,68.8,5,10,4,6,13,31,25,1
2877,0,0,0,0,0,0,0,,0,0,0,0,0,0,0,0
2878,48,26,21,25,2,14,34,41.2,20,11,3,8,17,65,13,0
2879,3,1,1,0,2,1,2,50,1,1,0,1,4,7,0,0
2880,33,16,10,13,10,11,19,57.9,8,17,2,15,20,53,5,0
2881,13,7,11,1,1,7,10,70,3,14,4,10,15,28,38,2
2882,40,20,14,15,11,10,31,32.3,21,28,0,28,5,45,5,0
2883,11,7,3,6,2,3,11,27.3,8,16,3,13,11,22,7,0
2884,23,14,9,10,4,12,35,34.3,23,25,5,20,19,42,22,1
2885,31,22,20,8,3,16,22,72.7,6,14,4,10,13,44,35,0
2886,32,19,17,11,4,21,35,60,14,18,1,17,16,48,4,0
2887,50,26,24,17,9,25,51,49,26,31,5,26,24,74,33,1
2888,24,15,0,15,9,6,28,21.4,22,19,0,19,7,31,6,0
2889,10,7,6,3,1,3,5,60,2,2,1,1,4,14,16,0
2890,1,0,1,0,0,0,1,0,1,0,0,0,0,1,0,0
2891,6,2,0,4,2,4,8,50,4,8,1,7,3,9,5,0
2892,21,9,12,6,3,6,24,25,18,15,5,10,14,35,28,0
2893,32,22,12,13,7,19,37,51.4,18,32,2,30,12,44,22,0
2894,13,5,4,7,2,3,28,10.7,25,17,10,7,19,32,10,0
2895,2,2,1,1,0,1,1,100,0,3,0,3,0,2,3,0
2896,72,44,34,29,9,37,71,52.1,34,32,8,24,58,130,48,0
2897,11,10,6,4,1,6,12,50,6,12,4,8,11,22,21,1
2898,15,11,6,8,1,5,14,35.7,9,12,4,8,12,27,22,1
2899,1,0,0,0,1,1,5,20,4,0,0,0,1,2,1,0
2900,2,2,2,0,0,2,2,100,0,0,0,0,2,4,21,1
2901,14,7,3,5,6,3,12,25,9,10,1,9,2,16,12,0
2902,0,0,0,0,0,0,1,0,1,1,1,0,2,2,0,0
2903,14,5,2,8,4,5,6,83.3,1,4,1,3,2,16,2,0
2904,0,0,0,0,0,0,1,0,1,0,0,0,0,0,1,1
2905,19,12,5,9,5,6,21,28.6,15,13,2,11,8,27,4,0
2906,20,12,8,11,1,9,20,45,11,15,13,2,23,43,42,0
2907,6,3,5,1,0,3,4,75,1,0,0,0,1,7,4,0
2908,20,14,7,10,3,11,20,55,9,11,3,8,14,34,15,1
2909,19,10,5,12,2,10,36,27.8,26,11,1,10,10,29,10,0
2910,1,0,1,0,0,1,1,100,0,0,0,0,0,1,4,0
2911,4,2,2,1,1,1,3,33.3,2,3,0,3,4,8,2,0
2912,21,15,9,7,5,11,19,57.9,8,14,2,12,7,28,33,0
2913,1,0,1,0,0,1,2,50,1,0,0,0,0,1,2,0
2914,11,6,8,3,0,4,7,57.1,3,31,26,5,34,45,132,0
2915,0,0,0,0,0,0,0,,0,0,0,0,0,0,1,0
2916,20,10,12,8,0,12,18,66.7,6,16,6,10,27,47,53,0
2917,52,25,19,30,3,22,44,50,22,30,13,17,49,101,48,1
2918,58,33,24,21,13,29,68,42.6,39,43,10,33,35,93,32,1
2919,49,21,6,24,19,22,61,36.1,39,18,1,17,11,60,11,1
2920,1,1,0,1,0,1,3,33.3,2,6,1,5,2,3,32,0
2921,13,10,7,1,5,5,13,38.5,8,7,1,6,4,17,1,0