Rk,Tkl.Tack,TklW.Tack,Def 3rd.Tack,Mid 3rd.Tack,Att 3rd.Tack,Tkl.Chal,Att.Chal,Tkl%.Chal,Lost.Chal,Blocks,Sh.Bloc,.Bloc,Int,Tkl+Int,Clr,Err
1,38,14,13,19,6,12,39,30.8,27,39,3,36,4,42,6,1
2,0,0,0,0,0,0,0,,0,0,0,0,0,0,0,0
3,1,1,0,1,0,0,0,,0,0,0,0,0,1,0,0
4,71,42,42,28,1,32,41,78,9,57,22,35,55,126,106,1
5,43,23,15,21,7,19,37,51.4,18,19,1,18,17,60,12,0
6,41,23,15,22,4,24,43,55.8,19,34,8,26,31,72,17,0
7,70,42,47,21,2,26,61,42.6,35,30,6,24,19,89,27,0
8,2,2,1,0,1,1,4,25,3,2,0,2,1,3,3,0
9,3,1,0,2,1,0,5,0,5,5,1,4,1,4,1,0
10,1,1,0,0,1,1,1,100,0,1,0,1,2,3,1,0
11,11,8,9,2,0,7,13,53.8,6,5,2,3,6,17,15,0
12,27,20,12,6,9,10,37,27,27,14,1,13,20,47,19,0
13,12,7,3,5,4,3,13,23.1,10,10,4,6,3,15,10,0
14,1,0,1,0,0,0,2,0,2,0,0,0,0,1,0,0
15,27,15,17,6,4,16,22,72.7,6,13,7,6,29,56,58,0
16,0,0,0,0,0,0,0,,0,0,0,0,0,0,0,0
17,1,1,1,0,0,1,1,100,0,0,0,0,0,1,0,0
18,49,29,31,13,5,24,34,70.6,10,13,5,8,19,68,27,0
19,17,13,7,8,2,7,11,63.6,4,13,4,9,4,21,19,0
20,89,46,44,35,10,50,77,64.9,27,48,8,40,35,124,29,0
21,13,6,4,3,6,6,14,42.9,8,12,0,12,3,16,5,0
22,15,6,11,3,1,7,11,63.6,4,11,8,3,16,31,80,1
23,3,3,2,1,0,3,4,75,1,3,1,2,3,6,3,0
24,11,7,3,5,3,6,20,30,14,11,0,11,6,17,1,0
25,12,9,3,4,5,3,11,27.3,8,24,2,22,5,17,6,0
26,6,3,2,4,0,2,2,100,0,2,0,2,1,7,1,0
27,10,4,3,4,3,2,12,16.7,10,12,2,10,6,16,6,0
28,6,3,4,1,1,2,7,28.6,5,4,1,3,1,7,3,0
29,55,35,41,12,2,33,48,68.8,15,24,9,15,26,81,89,3
30,0,0,0,0,0,0,0,,0,0,0,0,0,0,1,0
31,29,15,11,10,8,12,21,57.1,9,8,1,7,20,49,16,0
32,1,0,0,1,0,0,0,,0,1,1,0,0,1,0,0
33,20,11,12,6,2,12,19,63.2,7,13,3,10,9,29,9,0
34,63,33,17,27,19,21,52,40.4,31,35,5,30,9,72,6,0
35,16,12,11,5,0,9,12,75,3,12,11,1,13,29,47,2
36,16,6,7,4,5,6,15,40,9,7,0,7,14,30,25,1
37,3,2,3,0,0,1,3,33.3,2,2,0,2,0,3,0,0
38,17,11,7,7,3,8,20,40,12,16,5,11,8,25,7,0
39,1,1,0,1,0,0,1,0,1,0,0,0,1,2,0,0
40,31,19,10,18,3,11,27,40.7,16,19,0,19,24,55,11,0
41,44,30,29,14,1,15,23,65.2,8,23,12,11,24,68,125,0
42,15,11,5,7,3,8,14,57.1,6,11,2,9,9,24,26,0
43,33,20,25,7,1,9,14,64.3,5,3,0,3,9,42,27,0
44,47,28,28,17,2,28,42,66.7,14,22,12,10,22,69,46,2
45,11,8,5,4,2,9,16,56.3,7,6,5,1,7,18,22,0
46,5,4,1,4,0,3,9,33.3,6,3,1,2,2,7,7,0
47,3,3,1,1,1,0,4,0,4,8,2,6,0,3,5,0
48,27,18,11,13,3,19,31,61.3,12,25,8,17,14,41,26,0
49,22,8,13,7,2,9,13,69.2,4,17,9,8,18,40,38,0
50,27,16,19,6,2,12,18,66.7,6,22,6,16,13,40,37,0
51,6,3,3,3,0,1,5,20,4,2,0,2,3,9,2,0
52,10,6,8,2,0,8,13,61.5,5,0,0,0,6,16,2,1
53,37,28,18,14,5,13,22,59.1,9,29,4,25,12,49,23,0
54,66,37,40,23,3,27,37,73,10,40,13,27,16,82,48,1
55,14,11,7,4,3,9,15,60,6,17,9,8,14,28,33,1
56,0,0,0,0,0,0,2,0,2,0,0,0,0,0,0,0
57,3,2,0,2,1,1,2,50,1,1,0,1,2,5,2,0
58,3,2,1,0,2,0,1,0,1,0,0,0,1,4,12,0
59,20,14,10,10,0,11,25,44,14,9,4,5,10,30,19,0
60,31,17,14,12,5,15,50,30,35,26,5,21,6,37,3,0
61,25,17,17,6,2,14,18,77.8,4,17,13,4,14,39,107,0
62,4,1,0,2,2,1,8,12.5,7,6,2,4,1,5,5,0
63,43,24,20,21,2,14,22,63.6,8,14,3,11,19,62,12,2
64,5,3,0,4,1,3,8,37.5,5,8,3,5,1,6,8,0
65,34,24,19,14,1,15,40,37.5,25,14,5,9,15,49,27,0
66,24,14,14,10,0,18,26,69.2,8,14,9,5,18,42,52,0
67,28,19,17,7,4,16,32,50,16,13,2,11,2,30,10,1
68,0,0,0,0,0,0,0,,0,0,0,0,0,0,1,1
69,17,10,7,5,5,4,30,13.3,26,15,1,14,4,21,15,0
70,45,32,27,13,5,31,54,57.4,23,22,6,16,33,78,28,2
71,0,0,0,0,0,0,0,,0,0,0,0,0,0,0,0
72,26,12,14,12,0,21,41,51.2,20,15,5,10,3,29,8,0
73,6,3,5,1,0,0,4,0,4,6,0,6,2,8,2,0
74,7,4,3,4,0,3,7,42.9,4,1,0,1,1,8,0,0
75,0,0,0,0,0,0,3,0,3,3,0,3,0,0,14,0
76,35,22,20,11,4,16,54,29.6,38,22,1,21,17,52,17,1
77,0,0,0,0,0,0,0,,0,0,0,0,0,0,0,0
78,44,30,12,24,8,17,35,48.6,18,17,0,17,14,58,12,1
79,37,25,12,16,9,15,26,57.7,11,23,2,21,7,44,12,0
80,10,7,6,4,0,7,10,70,3,11,9,2,10,20,24,0
81,32,22,19,9,4,20,32,62.5,12,17,5,12,34,66,41,1
82,5,4,2,3,0,2,6,33.3,4,0,0,0,3,8,4,0
83,,1,,,,,,,,,,,0,,,
84,23,16,16,6,1,12,23,52.2,11,11,4,7,10,33,26,0
85,15,9,2,7,6,3,17,17.6,14,11,0,11,1,16,4,0
86,6,3,0,5,1,1,3,33.3,2,4,1,3,3,9,3,0
87,26,18,20,5,1,17,22,77.3,5,18,12,6,39,65,83,0
88,10,7,6,3,1,7,11,63.6,4,7,3,4,10,20,20,0
89,4,3,2,2,0,1,2,50,1,0,0,0,1,5,0,0
90,19,8,13,5,1,12,14,85.7,2,24,17,7,8,27,71,0
91,21,13,9,5,7,10,15,66.7,5,5,0,5,3,24,2,0
92,3,2,3,0,0,1,3,33.3,2,3,0,3,4,7,7,0
93,1,0,1,0,0,1,4,25,3,1,0,1,0,1,2,1
94,40,24,23,10,7,17,21,81,4,22,9,13,20,60,64,1
95,1,1,1,0,0,1,2,50,1,1,0,1,0,1,4,0
96,41,27,28,13,0,16,31,51.6,15,19,10,9,19,60,43,1
97,9,3,3,5,1,5,12,41.7,7,7,0,7,4,13,9,1
98,52,29,23,24,5,13,33,39.4,20,37,16,21,27,79,73,0
99,30,18,13,11,6,14,25,56,11,22,5,17,19,49,15,2
100,4,3,2,2,0,2,5,40,3,1,0,1,4,8,4,0
101,27,12,18,9,0,13,24,54.2,11,22,11,11,21,48,160,0
102,9,5,5,2,2,5,8,62.5,3,6,1,5,4,13,0,0
103,55,36,19,31,5,20,55,36.4,35,41,4,37,19,74,18,0
104,106,60,39,53,14,53,107,49.5,54,44,7,37,35,141,49,0
105,13,5,2,7,4,2,15,13.3,13,7,1,6,8,21,11,0
106,52,32,25,23,4,21,34,61.8,13,25,9,16,33,85,44,2
107,30,18,15,12,3,16,25,64,9,24,5,19,20,50,48,0
108,10,8,6,3,1,8,15,53.3,7,7,3,4,6,16,10,0
109,27,15,14,7,6,7,22,31.8,15,21,1,20,8,35,15,0
110,1,0,1,0,0,1,1,100,0,0,0,0,0,1,0,0
111,42,24,23,17,2,23,44,52.3,21,35,14,21,32,74,101,2
112,5,4,3,2,0,5,10,50,5,2,0,2,3,8,11,0
113,13,7,1,7,5,3,7,42.9,4,11,4,7,4,17,5,0
114,19,7,9,8,2,7,20,35,13,12,0,12,7,26,4,0
115,6,5,3,3,0,1,5,20,4,5,4,1,2,8,10,1
116,16,11,4,5,7,5,19,26.3,14,10,0,10,3,19,10,0
117,4,4,0,1,3,0,0,,0,5,2,3,3,7,3,0
118,10,4,4,4,2,3,7,42.9,4,10,1,9,7,17,3,0
119,4,1,2,1,1,1,6,16.7,5,1,0,1,3,7,0,0
120,21,11,14,7,0,10,27,37,17,13,5,8,10,31,16,0
121,0,0,0,0,0,0,0,,0,1,0,1,0,0,0,0
122,14,6,9,4,1,3,17,17.6,14,17,5,12,12,26,16,0
123,17,7,7,10,0,12,20,60,8,4,0,4,7,24,4,0
124,20,13,10,9,1,5,8,62.5,3,10,4,6,10,30,29,0
125,0,0,0,0,0,0,0,,0,0,0,0,0,0,0,0
126,1,1,0,0,1,0,3,0,3,1,0,1,0,1,2,0
127,0,0,0,0,0,0,0,,0,0,0,0,0,0,0,0
128,29,19,13,12,4,11,19,57.9,8,13,1,12,8,37,10,0
129,11,7,3,5,3,0,7,0,7,15,3,12,4,15,5,0
130,23,14,9,11,3,11,32,34.4,21,15,0,15,6,29,7,0
131,8,5,2,4,2,1,5,20,4,9,1,8,2,10,8,0
132,48,23,17,24,7,22,44,50,22,29,10,19,21,69,55,0
133,1,1,1,0,0,0,0,,0,0,0,0,0,1,0,0
134,0,0,0,0,0,0,0,,0,0,0,0,0,0,0,0
135,2,2,2,0,0,2,3,66.7,1,0,0,0,0,2,11,1
136,1,1,0,1,0,1,1,100,0,0,0,0,0,1,0,0
137,21,12,9,11,1,9,26,34.6,17,12,0,12,7,28,9,0
138,0,0,0,0,0,0,0,,0,1,0,1,0,0,0,0
139,8,2,1,3,4,4,8,50,4,9,1,8,0,8,8,0
140,7,6,5,1,1,6,19,31.6,13,10,1,9,1,8,11,1
141,9,5,2,2,5,3,7,42.9,4,12,1,11,7,16,3,0
142,29,14,17,10,2,14,35,40,21,14,2,12,13,42,11,0
143,0,0,0,0,0,0,0,,0,0,0,0,0,0,10,2
144,13,9,7,5,1,7,17,41.2,10,5,1,4,3,16,4,0
145,7,3,2,3,2,4,8,50,4,11,3,8,11,18,6,0
146,0,0,0,0,0,0,4,0,4,2,0,2,3,3,3,0
147,8,4,1,5,2,5,5,100,0,2,0,2,2,10,3,0
148,6,2,0,3,3,2,12,16.7,10,8,1,7,6,12,19,0
149,6,2,4,2,0,2,4,50,2,4,0,4,2,8,3,0
150,34,19,16,14,4,21,27,77.8,6,6,0,6,11,45,11,0
151,2,1,0,0,2,1,1,100,0,0,0,0,0,2,0,0
152,1,0,1,0,0,0,1,0,1,2,0,2,2,3,4,2
153,0,0,0,0,0,0,0,,0,0,0,0,0,0,0,0
154,0,0,0,0,0,0,2,0,2,0,0,0,0,0,7,1
155,15,12,11,2,2,7,13,53.8,6,18,7,11,9,24,43,1
156,1,1,1,0,0,0,0,,0,0,0,0,0,1,1,0
157,1,0,1,0,0,1,3,33.3,2,1,0,1,1,2,3,0
158,50,33,32,15,3,16,23,69.6,7,27,9,18,22,72,54,0
159,22,10,10,10,2,7,16,43.8,9,13,2,11,12,34,13,0
160,7,4,2,3,2,5,21,23.8,16,9,1,8,6,13,14,0
161,12,6,7,5,0,7,10,70,3,15,10,5,13,25,70,1
162,10,8,0,7,3,5,7,71.4,2,8,2,6,1,11,10,0
163,1,1,0,1,0,0,0,,0,0,0,0,0,1,0,0
164,24,17,13,9,2,11,23,47.8,12,11,0,11,10,34,14,0
165,4,2,0,3,1,2,4,50,2,4,0,4,0,4,6,0
166,58,38,21,19,18,18,42,42.9,24,29,2,27,13,71,28,0
167,10,4,6,4,0,7,7,100,0,5,4,1,5,15,26,1
168,51,27,37,8,6,31,64,48.4,33,28,8,20,20,71,39,2
169,0,0,0,0,0,0,0,,0,0,0,0,0,0,0,0
170,5,3,1,3,1,1,7,14.3,6,3,0,3,1,6,7,0
171,28,17,17,7,4,16,22,72.7,6,20,4,16,15,43,42,0
172,0,0,0,0,0,0,0,,0,0,0,0,0,0,0,0
173,25,14,13,12,0,12,25,48,13,12,3,9,8,33,21,0
174,21,11,17,4,0,10,22,45.5,12,24,17,7,21,42,75,0
175,10,9,7,2,1,5,10,50,5,9,5,4,14,24,41,0
176,1,1,1,0,0,0,0,,0,0,0,0,1,2,3,0
177,1,0,1,0,0,1,2,50,1,0,0,0,0,1,12,2
178,10,6,6,4,0,6,9,66.7,3,3,2,1,10,20,26,1
179,10,8,6,4,0,5,10,50,5,9,6,3,17,27,40,1
180,22,12,7,10,5,12,29,41.4,17,13,3,10,5,27,14,0
181,4,2,3,0,1,3,6,50,3,0,0,0,0,4,2,1
182,11,5,4,6,1,3,15,20,12,12,0,12,5,16,10,0
183,10,8,4,5,1,6,6,100,0,14,11,3,11,21,14,0
184,4,3,3,1,0,1,2,50,1,2,1,1,2,6,4,0
185,3,2,2,1,0,2,3,66.7,1,1,0,1,1,4,3,0
186,9,6,5,3,1,8,27,29.6,19,7,0,7,9,18,4,0
187,8,4,3,3,2,4,6,66.7,2,5,0,5,7,15,4,0
188,5,2,3,2,0,3,6,50,3,5,1,4,4,9,2,0
189,2,1,2,0,0,2,2,100,0,0,0,0,0,2,0,0
190,5,5,4,1,0,3,3,100,0,0,0,0,0,5,0,1
191,12,7,6,6,0,3,8,37.5,5,14,2,12,11,23,15,2
192,39,17,23,13,3,24,46,52.2,22,39,6,33,18,57,45,0
193,18,9,7,10,1,5,24,20.8,19,12,1,11,2,20,4,0
194,30,20,18,9,3,16,27,59.3,11,21,2,19,9,39,14,1
195,26,13,18,4,4,17,28,60.7,11,14,3,11,20,46,30,0
196,11,10,1,8,2,8,11,72.7,3,11,2,9,1,12,2,2
197,4,4,1,2,1,4,4,100,0,0,0,0,1,5,2,0
198,42,27,29,11,2,22,33,66.7,11,41,26,15,48,90,74,1
199,38,23,20,14,4,13,20,65,7,19,2,17,19,57,60,1
200,7,2,2,5,0,4,5,80,1,8,3,5,1,8,1,0
201,6,3,0,4,2,1,14,7.1,13,17,1,16,2,8,12,0
202,16,8,10,5,1,11,11,100,0,4,1,3,11,27,14,0
203,28,13,10,10,8,12,33,36.4,21,30,1,29,17,45,11,0
204,9,6,0,6,3,4,17,23.5,13,8,3,5,5,14,9,0
205,23,14,9,11,3,10,30,33.3,20,20,2,18,3,26,2,0
206,46,29,17,21,8,13,31,41.9,18,17,5,12,11,57,35,0
207,26,17,10,13,3,11,27,40.7,16,11,1,10,17,43,11,0
208,10,7,4,5,1,6,14,42.9,8,7,1,6,6,16,8,0
209,0,0,0,0,0,0,0,,0,0,0,0,0,0,0,0
210,19,9,5,5,9,5,15,33.3,10,13,1,12,3,22,10,0
211,7,2,4,3,0,5,11,45.5,6,0,0,0,8,15,1,0
212,20,14,6,9,5,7,29,24.1,22,24,0,24,11,31,6,0
213,77,49,49,23,5,47,71,66.2,24,29,2,27,40,117,31,1
214,0,0,0,0,0,0,0,,0,0,0,0,0,0,0,0
215,7,3,4,1,2,3,7,42.9,4,5,2,3,11,18,5,0
216,37,20,14,19,4,20,41,48.8,21,23,4,19,9,46,10,0
217,7,3,4,2,1,2,11,18.2,9,3,0,3,3,10,2,0
218,11,5,5,2,4,5,9,55.6,4,6,1,5,4,15,5,0
219,14,7,9,3,2,3,6,50,3,5,0,5,3,17,7,0
220,21,13,8,10,3,10,35,28.6,25,26,1,25,7,28,8,0
221,42,26,13,20,9,15,32,46.9,17,30,11,19,34,76,26,0
222,8,3,3,4,1,3,5,60,2,3,0,3,2,10,3,0
223,11,8,10,1,0,6,15,40,9,6,1,5,4,15,5,0
224,27,17,9,15,3,7,34,20.6,27,11,0,11,16,43,7,0
225,12,8,2,8,2,6,10,60,4,9,1,8,7,19,3,0
226,15,3,7,5,3,5,7,71.4,2,17,1,16,1,16,4,0
227,28,21,25,3,0,11,17,64.7,6,33,22,11,32,60,152,0
228,5,3,3,1,1,2,6,33.3,4,9,0,9,7,12,8,0
229,8,6,3,4,1,3,12,25,9,7,0,7,2,10,3,0
230,36,18,17,12,7,10,20,50,10,19,7,12,20,56,35,0
231,39,19,18,16,5,10,23,43.5,13,16,4,12,8,47,10,0
232,12,5,7,5,0,6,14,42.9,8,16,7,9,5,17,18,0
233,24,13,17,7,0,15,26,57.7,11,21,8,13,22,46,65,0
234,0,0,0,0,0,0,0,,0,0,0,0,0,0,12,1
235,9,5,5,2,2,4,17,23.5,13,11,3,8,1,10,14,0
236,14,3,5,5,4,6,16,37.5,10,4,2,2,4,18,15,0
237,30,16,9,15,6,6,39,15.4,33,50,5,45,14,44,16,1
238,47,34,14,17,16,20,39,51.3,19,20,3,17,21,68,13,0
239,3,0,3,0,0,1,1,100,0,1,1,0,1,4,2,0
240,0,0,0,0,0,0,1,0,1,1,0,1,0,0,0,0
241,1,0,1,0,0,1,1,100,0,0,0,0,1,2,22,2
242,0,0,0,0,0,0,2,0,2,1,0,1,0,0,0,0
243,9,9,1,5,3,4,7,57.1,3,8,1,7,4,13,5,0
244,62,30,46,13,3,37,46,80.4,9,37,21,16,17,79,54,1
245,0,0,0,0,0,0,0,,0,0,0,0,1,1,1,0
246,2,1,1,1,0,0,0,,0,0,0,0,0,2,0,0
247,12,4,1,6,5,2,10,20,8,7,1,6,2,14,4,1
248,20,14,15,5,0,9,11,81.8,2,22,15,7,29,49,46,0
249,3,3,0,3,0,1,1,100,0,3,1,2,2,5,5,0
250,0,0,0,0,0,0,1,0,1,2,1,1,1,1,1,0
251,0,0,0,0,0,0,0,,0,0,0,0,0,0,1,0
252,2,0,1,0,1,1,2,50,1,0,0,0,1,3,0,0
253,10,6,3,4,3,3,14,21.4,11,13,2,11,4,14,20,0
254,11,4,5,6,0,2,10,20,8,6,1,5,10,21,2,0
255,6,4,2,1,3,3,4,75,1,9,1,8,9,15,7,0
256,1,0,0,1,0,1,1,100,0,1,0,1,0,1,0,0
257,15,9,2,7,6,7,19,36.8,12,10,1,9,5,20,4,0
258,5,2,3,2,0,2,7,28.6,5,2,0,2,1,6,1,0
259,62,37,28,30,4,37,67,55.2,30,25,4,21,39,101,14,3
260,32,20,26,6,0,16,30,53.3,14,28,12,16,37,69,94,0
261,29,13,22,7,0,11,14,78.6,3,25,9,16,40,69,88,0
262,6,3,4,1,1,3,4,75,1,2,1,1,3,9,5,0
263,2,0,1,1,0,2,2,100,0,0,0,0,0,2,0,0
264,32,17,13,14,5,6,16,37.5,10,18,3,15,22,54,19,0
265,2,0,0,2,0,2,3,66.7,1,2,0,2,3,5,2,0
266,65,35,24,28,13,32,44,72.7,12,43,3,40,29,94,23,0
267,0,0,0,0,0,0,1,0,1,1,1,0,1,1,4,0
268,9,5,3,2,4,3,8,37.5,5,8,1,7,3,12,2,0
269,27,18,10,13,4,10,42,23.8,32,19,4,15,41,68,30,2
270,15,9,4,10,1,3,9,33.3,6,10,0,10,3,18,0,0
271,0,0,0,0,0,0,0,,0,1,0,1,0,0,0,0
272,11,7,2,3,6,4,11,36.4,7,13,0,13,4,15,0,0
273,3,3,2,0,1,3,4,75,1,0,0,0,1,4,1,0
274,16,10,7,5,4,10,18,55.6,8,11,0,11,9,25,9,0
275,1,1,0,0,1,1,2,50,1,0,0,0,0,1,0,0
276,54,29,23,29,2,26,44,59.1,18,21,7,14,24,78,15,1
277,18,10,8,4,6,8,24,33.3,16,14,1,13,9,27,11,0
278,33,21,20,10,3,25,36,69.4,11,37,12,25,27,60,83,1
279,67,37,28,32,7,32,53,60.4,21,29,9,20,39,106,25,3
280,45,28,15,21,9,16,28,57.1,12,28,15,13,20,65,22,0
281,7,4,2,2,3,1,6,16.7,5,9,0,9,1,8,5,0
282,18,12,7,6,5,7,30,23.3,23,9,0,9,13,31,14,0
283,32,18,15,13,4,19,32,59.4,13,23,8,15,26,58,44,1
284,43,28,12,17,14,17,43,39.5,26,25,1,24,8,51,6,0
285,28,18,15,11,2,17,26,65.4,9,18,4,14,21,49,25,0
286,0,0,0,0,0,0,1,0,1,0,0,0,1,1,0,0
287,14,6,5,6,3,6,18,33.3,12,8,2,6,5,19,9,0
288,11,6,4,3,4,4,13,30.8,9,14,1,13,0,11,19,0
289,9,7,4,2,3,7,15,46.7,8,9,1,8,15,24,17,0
290,2,0,2,0,0,2,2,100,0,1,0,1,1,3,9,1
291,24,13,16,6,2,17,30,56.7,13,8,1,7,8,32,16,1
292,27,16,11,13,3,16,23,69.6,7,14,4,10,2,29,19,0
293,0,0,0,0,0,0,0,,0,0,0,0,0,0,0,0
294,16,9,0,9,7,4,15,26.7,11,15,2,13,4,20,25,0
295,0,0,0,0,0,0,0,,0,0,0,0,0,0,0,0
296,32,19,21,9,2,20,31,64.5,11,27,16,11,16,48,103,0
297,3,1,1,2,0,2,2,100,0,1,0,1,0,3,0,0
298,2,1,2,0,0,1,1,100,0,0,0,0,1,3,0,0
299,3,0,2,1,0,1,4,25,3,2,1,1,4,7,5,0
300,30,17,24,6,0,14,25,56,11,21,11,10,29,59,78,0
301,23,15,18,5,0,9,17,52.9,8,33,19,14,23,46,137,0
302,4,3,2,1,1,0,3,0,3,5,1,4,1,5,22,0
303,0,0,0,0,0,0,0,,0,2,0,2,0,0,1,0
304,56,32,20,27,9,11,33,33.3,22,41,8,33,28,84,50,1
305,0,0,0,0,0,0,0,,0,1,1,0,1,1,0,0
306,54,32,26,24,4,29,53,54.7,24,26,6,20,13,67,37,1
307,25,13,15,8,2,16,23,69.6,7,21,7,14,13,38,23,0
308,10,7,3,4,3,7,16,43.8,9,11,2,9,6,16,0,0
309,11,7,4,3,4,5,7,71.4,2,4,0,4,0,11,1,0
310,12,10,3,5,4,2,7,28.6,5,12,5,7,9,21,7,0
311,3,1,3,0,0,0,5,0,5,3,0,3,0,3,4,0
312,28,16,5,16,7,12,26,46.2,14,9,0,9,9,37,9,0
313,0,0,0,0,0,0,1,0,1,1,0,1,0,0,19,4
314,6,4,5,1,0,4,6,66.7,2,5,0,5,1,7,3,0
315,11,4,7,3,1,6,13,46.2,7,4,1,3,1,12,5,0
316,0,0,0,0,0,0,0,,0,0,0,0,0,0,1,0
317,36,24,13,15,8,13,36,36.1,23,23,1,22,14,50,6,0
318,0,0,0,0,0,0,0,,0,0,0,0,0,0,6,0
319,6,5,6,0,0,6,12,50,6,24,18,6,21,27,68,1
320,0,0,0,0,0,0,0,,0,0,0,0,0,0,2,0
321,52,27,21,23,8,29,51,56.9,22,40,11,29,25,77,65,0
322,2,0,2,0,0,0,1,0,1,4,2,2,2,4,6,0
323,1,1,0,0,1,0,4,0,4,0,0,0,0,1,1,0
324,2,0,1,1,0,1,3,33.3,2,4,2,2,5,7,15,0
325,6,4,3,2,1,1,7,14.3,6,5,2,3,0,6,4,0
326,0,0,0,0,0,0,0,,0,1,0,1,0,0,0,0
327,24,14,15,7,2,6,18,33.3,12,18,1,17,11,35,8,0
328,8,4,2,2,4,2,4,50,2,6,0,6,1,9,1,0
329,18,10,11,5,2,9,16,56.3,7,12,5,7,10,28,14,0
330,6,2,1,4,1,3,4,75,1,3,1,2,4,10,2,0
331,13,6,8,3,2,8,13,61.5,5,11,4,7,12,25,38,0
332,33,21,14,15,4,22,34,64.7,12,14,0,14,15,48,4,1
333,3,1,0,1,2,0,9,0,9,9,1,8,3,6,0,0
334,1,0,1,0,0,0,0,,0,1,0,1,0,1,0,0
335,17,13,7,8,2,9,24,37.5,15,15,1,14,5,22,13,0
336,6,4,4,2,0,3,6,50,3,6,4,2,6,12,21,0
337,5,4,1,4,0,2,4,50,2,10,7,3,9,14,24,0
338,70,43,43,19,8,42,67,62.7,25,38,10,28,36,106,52,1
339,2,2,0,2,0,2,2,100,0,0,0,0,0,2,0,0
340,15,10,9,5,1,7,12,58.3,5,18,9,9,23,38,62,0
341,21,14,4,10,7,3,12,25,9,8,2,6,2,23,6,0
342,5,4,0,3,2,3,3,100,0,1,0,1,0,5,1,0
343,30,18,25,5,0,17,23,73.9,6,36,17,19,27,57,98,2
344,3,2,2,0,1,2,4,50,2,0,0,0,1,4,3,0
345,4,2,2,1,1,0,2,0,2,1,0,1,0,4,1,0
346,4,2,1,2,1,2,6,33.3,4,2,0,2,0,4,0,0
347,50,24,27,20,3,27,37,73,10,23,5,18,24,74,12,0
348,3,0,1,2,0,3,5,60,2,0,0,0,2,5,2,0
349,14,9,7,4,3,3,14,21.4,11,6,0,6,5,19,1,0
350,2,1,2,0,0,2,3,66.7,1,3,2,1,0,2,3,0
351,2,1,2,0,0,1,4,25,3,0,0,0,2,4,10,1
352,6,4,4,2,0,5,6,83.3,1,2,1,1,2,8,3,0
353,35,16,12,18,5,17,35,48.6,18,35,12,23,26,61,45,0
354,38,24,14,18,6,17,51,33.3,34,32,1,31,23,61,24,0
355,12,5,3,6,3,6,15,40,9,6,1,5,2,14,6,0
356,34,12,11,10,13,14,45,31.1,31,41,7,34,28,62,18,0
357,26,13,7,12,7,13,25,52,12,26,5,21,12,38,31,0
358,5,3,2,3,0,0,0,,0,1,0,1,2,7,0,0
359,16,11,8,6,2,7,13,53.8,6,14,3,11,17,33,34,0
360,5,3,1,3,1,0,3,0,3,3,0,3,3,8,0,0
361,12,2,2,4,6,5,12,41.7,7,9,0,9,5,17,10,0
362,23,13,15,6,2,10,17,58.8,7,14,5,9,15,38,43,0
363,22,16,5,11,6,9,28,32.1,19,16,0,16,15,37,6,1
364,29,20,12,10,7,12,23,52.2,11,14,2,12,12,41,9,0
365,29,17,23,4,2,15,24,62.5,9,35,16,19,45,74,113,0
366,0,0,0,0,0,0,0,,0,0,0,0,1,1,0,0
367,0,0,0,0,0,0,0,,0,0,0,0,0,0,3,1
368,3,1,2,1,0,1,1,100,0,2,1,1,4,7,4,0
369,2,1,0,1,1,1,2,50,1,0,0,0,0,2,0,0
370,2,1,2,0,0,0,4,0,4,0,0,0,2,4,2,0
371,24,16,20,3,1,17,23,73.9,6,39,21,18,34,58,105,2
372,4,1,0,3,1,1,1,100,0,10,1,9,1,5,1,0
373,31,16,17,13,1,19,29,65.5,10,31,20,11,18,49,49,1
374,1,0,1,0,0,0,0,,0,0,0,0,0,1,2,0
375,9,6,3,6,0,7,10,70,3,5,1,4,8,17,48,0
376,0,0,0,0,0,0,4,0,4,0,0,0,0,0,4,0
377,19,11,6,11,2,6,23,26.1,17,17,7,10,17,36,19,0
378,32,22,22,8,2,26,39,66.7,13,22,6,16,36,68,66,0
379,0,0,0,0,0,0,0,,0,0,0,0,0,0,2,0
380,3,2,0,0,3,2,2,100,0,2,0,2,1,4,0,0
381,10,5,7,3,0,7,13,53.8,6,11,1,10,16,26,14,0
382,3,1,3,0,0,0,3,0,3,3,0,3,1,4,1,0
383,9,6,5,3,1,3,11,27.3,8,5,0,5,3,12,8,0
384,5,4,3,2,0,4,4,100,0,2,0,2,1,6,1,0
385,10,7,2,8,0,6,8,75,2,4,0,4,8,18,12,0
386,12,5,0,8,4,0,5,0,5,8,0,8,3,15,13,0
387,46,20,18,18,10,17,56,30.4,39,15,1,14,18,64,14,0
388,28,14,22,3,3,16,28,57.1,12,12,1,11,9,37,30,0
389,47,26,29,17,1,19,22,86.4,3,27,20,7,27,74,81,1
390,1,0,0,0,1,0,0,,0,0,0,0,0,1,0,0
391,18,10,8,6,4,10,26,38.5,16,27,1,26,10,28,14,0
392,14,8,4,5,5,6,14,42.9,8,9,0,9,10,24,5,0
393,0,0,0,0,0,0,1,0,1,0,0,0,0,0,0,0
394,27,16,16,11,0,12,20,60,8,28,14,14,44,71,69,2
395,3,3,1,1,1,2,3,66.7,1,2,0,2,0,3,1,0
396,3,1,0,1,2,1,4,25,3,6,1,5,1,4,1,0
397,1,0,0,0,1,0,0,,0,2,0,2,0,1,0,0
398,45,31,22,16,7,27,53,50.9,26,34,11,23,24,69,106,2
399,16,12,8,7,1,10,18,55.6,8,9,3,6,8,24,16,0
400,49,25,21,22,6,24,41,58.5,17,24,6,18,21,70,29,2
401,19,10,10,9,0,8,13,61.5,5,9,1,8,5,24,17,0
402,0,0,0,0,0,0,1,0,1,0,0,0,1,1,0,0
403,7,4,2,4,1,2,6,33.3,4,0,0,0,1,8,2,0
404,3,3,3,0,0,3,4,75,1,5,4,1,3,6,5,0
405,56,34,19,24,13,26,50,52,24,34,3,31,15,71,6,1
406,20,12,10,8,2,12,26,46.2,14,5,0,5,4,24,12,0
407,34,18,24,10,0,20,29,69,9,29,21,8,32,66,91,2
408,19,7,10,6,3,8,12,66.7,4,10,5,5,4,23,11,0
409,42,21,25,13,4,19,28,67.9,9,18,4,14,44,86,30,0
410,0,0,0,0,0,0,0,,0,0,0,0,0,0,1,0
411,80,40,32,39,9,32,52,61.5,20,27,4,23,42,122,22,2
412,13,4,2,6,5,6,6,100,0,10,1,9,3,16,2,0
413,43,22,24,12,7,23,42,54.8,19,24,5,19,15,58,16,0
414,2,1,1,1,0,1,2,50,1,2,1,1,1,3,12,0
415,54,30,24,24,6,32,50,64,18,15,4,11,19,73,25,0
416,23,14,10,11,2,9,20,45,11,23,16,7,16,39,88,2
417,17,8,10,4,3,7,18,38.9,11,18,9,9,19,36,42,0
418,33,19,19,12,2,15,24,62.5,9,25,10,15,9,42,40,0
419,12,8,8,3,1,5,7,71.4,2,10,8,2,14,26,53,1
420,0,0,0,0,0,0,0,,0,0,0,0,0,0,1,0
421,39,21,15,20,4,12,35,34.3,23,25,4,21,22,61,9,1
422,2,1,2,0,0,2,2,100,0,1,0,1,0,2,3,0
423,8,5,5,3,0,4,5,80,1,3,2,1,3,11,2,0
424,2,2,1,1,0,2,3,66.7,1,0,0,0,1,3,4,0
425,3,1,1,0,2,1,4,25,3,2,0,2,1,4,5,0
426,52,29,15,34,3,20,33,60.6,13,35,4,31,32,84,15,0
427,10,9,3,6,1,4,9,44.4,5,2,0,2,7,17,4,0
428,67,40,28,36,3,37,66,56.1,29,39,4,35,21,88,12,1
429,1,1,0,0,1,0,0,,0,0,0,0,0,1,0,0
430,7,4,3,4,0,4,9,44.4,5,4,2,2,9,16,14,0
431,45,33,20,14,11,16,46,34.8,30,16,3,13,10,55,18,0
432,15,11,7,4,4,3,12,25,9,9,1,8,5,20,5,0
433,42,24,23,17,2,18,44,40.9,26,20,2,18,21,63,27,1
434,2,2,1,1,0,0,1,0,1,0,0,0,0,2,0,0
435,13,8,3,8,2,4,13,30.8,9,6,0,6,2,15,22,0
436,2,1,1,1,0,0,1,0,1,2,0,2,1,3,0,0
437,48,22,21,22,5,17,33,51.5,16,9,1,8,18,66,25,1
438,20,11,9,7,4,11,23,47.8,12,13,0,13,9,29,7,0
439,9,4,5,2,2,4,8,50,4,4,0,4,1,10,2,0
440,29,21,16,9,4,17,24,70.8,7,7,1,6,19,48,9,1
441,15,11,6,7,2,6,14,42.9,8,6,1,5,6,21,8,0
442,11,3,10,0,1,9,33,27.3,24,6,2,4,15,26,28,0
443,0,0,0,0,0,0,0,,0,0,0,0,0,0,0,0
444,0,0,0,0,0,0,2,0,2,3,1,2,0,0,1,0
445,1,1,1,0,0,1,1,100,0,2,0,2,0,1,1,0
446,35,21,17,14,4,21,49,42.9,28,21,3,18,14,49,23,0
447,18,10,5,12,1,9,14,64.3,5,9,3,6,14,32,18,1
448,14,6,3,9,2,7,20,35,13,16,1,15,7,21,3,0
449,3,1,0,0,3,0,3,0,3,0,0,0,1,4,3,0
450,2,2,0,1,1,0,0,,0,5,2,3,1,3,5,0
451,70,39,21,30,19,37,91,40.7,54,32,2,30,26,96,20,0
452,3,2,2,0,1,2,5,40,3,3,2,1,3,6,2,1
453,1,1,1,0,0,0,2,0,2,2,0,2,1,2,0,0
454,1,1,0,1,0,1,3,33.3,2,1,0,1,0,1,0,0
455,58,43,34,19,5,33,48,68.8,15,28,10,18,14,72,61,0
456,2,0,1,1,0,0,3,0,3,3,0,3,2,4,2,0
457,1,1,1,0,0,1,4,25,3,3,0,3,2,3,5,0
458,17,10,11,2,4,11,17,64.7,6,7,0,7,4,21,14,0
459,46,25,27,13,6,24,39,61.5,15,16,4,12,16,62,58,1
460,1,0,0,1,0,0,1,0,1,2,2,0,1,2,2,0
461,0,0,0,0,0,0,0,,0,0,0,0,1,1,7,1
462,0,0,0,0,0,0,0,,0,0,0,0,0,0,0,0
463,5,3,2,2,1,3,3,100,0,2,0,2,3,8,5,0
464,16,9,7,6,3,6,16,37.5,10,14,2,12,8,24,9,0
465,13,11,5,3,5,9,16,56.3,7,10,6,4,7,20,17,1
466,0,0,0,0,0,0,1,0,1,0,0,0,0,0,8,1
467,25,12,14,10,1,16,35,45.7,19,18,1,17,12,37,15,0
468,29,16,13,11,5,15,26,57.7,11,18,5,13,13,42,38,0
469,8,8,3,3,2,3,6,50,3,6,0,6,5,13,0,0
470,0,0,0,0,0,0,0,,0,0,0,0,1,1,0,0
471,33,20,16,15,2,11,34,32.4,23,23,5,18,10,43,14,0
472,35,17,21,14,0,17,27,63,10,16,9,7,13,48,53,0
473,58,29,28,23,7,29,51,56.9,22,32,8,24,24,82,44,0
474,0,0,0,0,0,0,0,,0,0,0,0,0,0,1,0
475,48,28,33,11,4,22,32,68.8,10,18,4,14,24,72,40,0
476,1,1,0,1,0,0,0,,0,1,1,0,0,1,0,0
477,76,41,46,24,6,37,70,52.9,33,44,11,33,37,113,80,0
478,25,13,11,13,1,10,30,33.3,20,9,2,7,11,36,15,0
479,0,0,0,0,0,0,0,,0,0,0,0,1,1,8,1
480,11,4,1,7,3,0,11,0,11,19,2,17,5,16,20,0
481,33,20,24,7,2,16,27,59.3,11,28,18,10,47,80,65,0
482,20,11,7,9,4,8,36,22.2,28,20,2,18,8,28,2,0
483,34,15,23,10,1,18,37,48.6,19,26,5,21,14,48,28,2
484,6,4,0,4,2,2,6,33.3,4,3,1,2,3,9,2,0
485,22,14,5,14,3,13,39,33.3,26,21,9,12,23,45,31,0
486,19,11,15,4,0,9,20,45,11,25,20,5,14,33,121,1
487,18,11,7,6,5,5,12,41.7,7,10,1,9,7,25,12,1
488,22,12,17,5,0,13,19,68.4,6,26,12,14,24,46,53,0
489,4,1,2,1,1,1,8,12.5,7,7,2,5,1,5,7,0
490,26,18,7,9,10,16,42,38.1,26,16,2,14,18,44,5,0
491,0,0,0,0,0,0,0,,0,1,1,0,3,3,1,0
492,20,15,11,8,1,10,16,62.5,6,14,7,7,13,33,44,0
493,20,16,7,6,7,7,13,53.8,6,11,1,10,3,23,23,0
494,4,1,4,0,0,3,4,75,1,2,0,2,1,5,0,0
495,33,16,16,15,2,20,28,71.4,8,25,5,20,13,46,29,1
496,6,5,6,0,0,4,6,66.7,2,5,2,3,3,9,12,0
497,37,25,20,15,2,20,28,71.4,8,17,6,11,36,73,38,0
498,59,36,23,30,6,26,54,48.1,28,26,1,25,27,86,13,0
499,3,0,0,3,0,2,2,100,0,1,0,1,1,4,1,0
500,,0,,,,,,,,,,,0,,,
501,30,21,17,10,3,16,26,61.5,10,19,12,7,26,56,77,0
502,6,4,1,5,0,2,3,66.7,1,3,0,3,6,12,1,0
503,10,7,7,2,1,3,9,33.3,6,7,5,2,8,18,9,2
504,24,13,6,11,7,13,43,30.2,30,28,3,25,16,40,25,1
505,1,1,1,0,0,1,1,100,0,0,0,0,0,1,2,0
506,17,11,12,2,3,11,18,61.1,7,8,3,5,15,32,38,1
507,8,6,6,2,0,6,8,75,2,5,4,1,7,15,5,1
508,2,2,2,0,0,2,2,100,0,1,0,1,0,2,3,0
509,2,1,0,2,0,0,4,0,4,2,0,2,0,2,5,0
510,30,17,18,12,0,12,23,52.2,11,29,13,16,43,73,60,1
511,68,41,29,26,13,25,62,40.3,37,24,6,18,34,102,13,0
512,2,2,1,0,1,0,1,0,1,1,0,1,0,2,5,0
513,0,0,0,0,0,0,1,0,1,0,0,0,0,0,0,0
514,12,7,1,5,6,6,17,35.3,11,5,0,5,4,16,0,0
515,6,4,4,0,2,5,8,62.5,3,5,1,4,4,10,7,0
516,1,1,1,0,0,1,1,100,0,1,0,1,2,3,6,2
517,0,0,0,0,0,0,0,,0,1,0,1,2,2,4,0
518,12,5,5,5,2,4,7,57.1,3,6,1,5,0,12,1,0
519,18,14,11,6,1,13,22,59.1,9,15,0,15,16,34,17,0
520,27,15,20,6,1,10,17,58.8,7,21,12,9,16,43,30,0
521,26,19,10,12,4,13,38,34.2,25,22,1,21,20,46,6,0
522,46,22,24,19,3,28,55,50.9,27,29,9,20,33,79,35,0
523,15,10,6,9,0,7,10,70,3,11,9,2,14,29,41,0
524,1,0,1,0,0,0,1,0,1,0,0,0,0,1,19,1
525,27,19,9,18,0,13,35,37.1,22,14,2,12,22,49,13,0
526,11,6,6,5,0,2,4,50,2,4,0,4,4,15,1,0
527,13,6,7,1,5,6,16,37.5,10,12,0,12,10,23,13,0
528,3,2,2,1,0,2,3,66.7,1,1,0,1,0,3,0,0
529,8,6,7,1,0,3,6,50,3,7,3,4,10,18,44,0
530,15,12,6,8,1,9,15,60,6,5,2,3,7,22,5,0
531,11,5,3,7,1,4,5,80,1,5,1,4,2,13,2,0
532,5,3,1,2,2,3,6,50,3,5,1,4,0,5,3,0
533,8,6,3,3,2,4,6,66.7,2,0,0,0,0,8,2,0
534,32,24,9,18,5,11,27,40.7,16,19,9,10,18,50,26,0
535,1,1,1,0,0,1,1,100,0,1,1,0,1,2,2,0
536,25,14,16,8,1,12,26,46.2,14,19,2,17,3,28,25,0
537,0,0,0,0,0,0,0,,0,2,0,2,0,0,0,0
538,3,2,2,1,0,3,3,100,0,0,0,0,2,5,1,0
539,13,8,5,7,1,6,14,42.9,8,6,0,6,1,14,1,0
540,34,21,13,15,6,17,38,44.7,21,22,3,19,24,58,32,2
541,53,35,37,14,2,21,32,65.6,11,17,4,13,13,66,47,1
542,27,16,13,9,5,14,23,60.9,9,22,4,18,19,46,34,0
543,14,9,8,6,0,7,15,46.7,8,20,16,4,14,28,85,3
544,12,6,5,3,4,3,10,30,7,10,3,7,8,20,4,0
545,10,5,6,4,0,4,9,44.4,5,9,4,5,8,18,35,1
546,18,13,12,6,0,5,8,62.5,3,3,0,3,3,21,9,0
547,35,26,21,10,4,19,29,65.5,10,14,7,7,21,56,58,2
548,2,0,1,1,0,1,1,100,0,5,0,5,3,5,2,0
549,22,11,11,9,2,7,11,63.6,4,10,1,9,2,24,3,0
550,0,0,0,0,0,0,0,,0,0,0,0,0,0,0,0
551,17,10,10,7,0,9,12,75,3,9,5,4,22,39,69,1
552,25,14,18,7,0,14,23,60.9,9,26,21,5,21,46,72,0
553,13,5,1,7,5,4,11,36.4,7,19,0,19,2,15,5,0
554,12,7,6,3,3,7,11,63.6,4,13,2,11,3,15,3,0
555,2,2,1,1,0,1,4,25,3,3,1,2,8,10,19,0
556,10,7,3,5,2,6,12,50,6,17,1,16,1,11,4,0
557,30,19,20,10,0,14,29,48.3,15,22,8,14,24,54,64,1
558,51,32,21,29,1,28,54,51.9,26,21,1,20,19,70,12,0
559,1,0,1,0,0,0,1,0,1,0,0,0,0,1,11,2
560,22,14,13,6,3,11,20,55,9,12,6,6,6,28,23,0
561,0,0,0,0,0,0,0,,0,0,0,0,0,0,0,0
562,36,22,9,22,5,17,35,48.6,18,25,9,16,21,57,26,0
563,8,4,4,4,0,5,7,71.4,2,16,11,5,12,20,51,0
564,28,20,21,6,1,15,23,65.2,8,8,3,5,26,54,42,2
565,35,19,22,12,1,16,22,72.7,6,23,8,15,32,67,63,2
566,20,14,11,9,0,10,17,58.8,7,18,6,12,12,32,33,0
567,18,13,7,9,2,7,7,100,0,8,2,6,9,27,7,0
568,16,6,10,2,4,11,22,50,11,9,3,6,14,30,21,0
569,5,2,3,0,2,3,3,100,0,1,0,1,0,5,0,0
570,1,0,1,0,0,0,0,,0,0,0,0,0,1,0,0
571,6,2,3,2,1,4,14,28.6,10,13,0,13,9,15,4,0
572,8,5,1,5,2,2,6,33.3,4,2,0,2,0,8,0,0
573,57,40,36,19,2,23,40,57.5,17,18,1,17,21,78,40,2
574,1,0,1,0,0,0,0,,0,1,0,1,0,1,0,0
575,14,13,3,7,4,6,12,50,6,20,3,17,9,23,21,0
576,13,7,1,10,2,7,19,36.8,12,18,0,18,11,24,6,0
577,2,0,2,0,0,1,4,25,3,5,1,4,2,4,10,0
578,37,25,19,11,7,20,31,64.5,11,11,3,8,12,49,30,0
579,0,0,0,0,0,0,0,,0,0,0,0,1,1,0,0
580,38,19,9,22,7,9,35,25.7,26,16,0,16,13,51,10,0
581,47,25,28,15,4,22,46,47.8,24,22,6,16,32,79,48,2
582,2,0,2,0,0,2,4,50,2,0,0,0,0,2,5,0
583,40,22,27,8,5,24,33,72.7,9,21,5,16,29,69,46,0
584,63,36,31,26,6,22,53,41.5,31,25,4,21,16,79,23,2
585,11,9,8,1,2,5,9,55.6,4,7,0,7,3,14,0,0
586,1,0,1,0,0,1,1,100,0,0,0,0,1,2,7,1
587,19,11,10,9,0,6,18,33.3,12,16,2,14,15,34,16,0
588,19,14,8,8,3,9,15,60,6,11,1,10,4,23,2,0
589,19,13,8,8,3,9,14,64.3,5,5,2,3,4,23,4,0
590,0,0,0,0,0,0,0,,0,0,0,0,0,0,0,0
591,38,21,27,9,2,26,38,68.4,12,11,5,6,21,59,35,1
592,0,0,0,0,0,0,0,,0,0,0,0,0,0,0,0
593,0,0,0,0,0,0,1,0,1,0,0,0,0,0,0,0
594,16,8,9,7,0,7,19,36.8,12,18,9,9,23,39,46,0
595,89,48,45,37,7,47,75,62.7,28,35,8,27,10,99,36,0
596,8,3,0,7,1,1,2,50,1,9,1,8,9,17,6,0
597,18,10,13,2,3,11,21,52.4,10,15,6,9,12,30,40,0
598,1,0,0,1,0,1,3,33.3,2,1,0,1,0,1,0,0
599,37,24,25,11,1,18,45,40,27,12,1,11,16,53,22,0
600,66,33,40,15,11,30,60,50,30,28,8,20,16,82,48,1
601,6,4,4,2,0,1,3,33.3,2,6,5,1,5,11,28,0
602,5,2,2,1,2,2,5,40,3,2,1,1,2,7,1,0
603,11,8,5,5,1,4,21,19,17,8,0,8,4,15,2,0
604,4,1,0,3,1,1,5,20,4,10,2,8,5,9,7,0
605,4,1,1,3,0,0,3,0,3,4,1,3,2,6,3,0
606,2,0,1,1,0,1,2,50,1,0,0,0,0,2,0,0
607,4,4,3,1,0,2,5,40,3,2,0,2,1,5,3,0
608,13,7,10,2,1,8,14,57.1,6,7,3,4,6,19,7,0
609,4,0,2,1,1,1,4,25,3,2,0,2,1,5,1,0
610,8,7,5,3,0,3,3,100,0,4,3,1,5,13,12,0
611,8,5,2,5,1,3,6,50,3,4,0,4,3,11,0,0
612,25,16,12,9,4,15,19,78.9,4,16,2,14,11,36,12,0
613,0,0,0,0,0,0,0,,0,0,0,0,0,0,0,0
614,11,9,3,4,4,7,7,100,0,6,2,4,7,18,3,0
615,9,5,3,6,0,1,7,14.3,6,10,2,8,4,13,6,0
616,8,6,2,2,4,1,10,10,9,12,3,9,2,10,15,0
617,44,33,33,11,0,28,40,70,12,22,7,15,28,72,46,1
618,6,3,1,2,3,1,2,50,1,3,0,3,0,6,0,0
619,20,14,8,9,3,9,34,26.5,25,14,1,13,9,29,11,0
620,42,21,29,11,2,19,32,59.4,13,28,12,16,22,64,66,0
621,2,0,2,0,0,1,1,100,0,4,1,3,0,2,1,0
622,9,5,4,4,1,2,11,18.2,9,6,1,5,0,9,8,0
623,63,40,42,17,4,32,48,66.7,16,26,15,11,36,99,88,1
624,1,0,1,0,0,0,0,,0,0,0,0,0,1,0,0
625,3,3,1,0,2,1,2,50,1,0,0,0,0,3,1,1
626,1,1,0,1,0,0,0,,0,0,0,0,1,2,0,0
627,33,17,21,11,1,17,27,63,10,36,26,10,29,62,103,0
628,46,27,29,13,4,19,35,54.3,16,43,26,17,39,85,100,1
629,13,7,8,5,0,6,11,54.5,5,8,5,3,6,19,31,1
630,50,27,11,28,11,19,47,40.4,28,24,0,24,20,70,19,0
631,21,14,15,5,1,14,20,70,6,16,10,6,19,40,65,2
632,1,1,0,1,0,0,0,,0,1,0,1,0,1,0,0
633,46,25,22,12,12,26,39,66.7,13,26,5,21,19,65,28,0
634,17,9,6,6,5,5,14,35.7,9,20,5,15,4,21,7,1
635,17,12,4,8,5,7,19,36.8,12,18,2,16,7,24,13,0
636,45,28,25,13,7,18,39,46.2,21,28,4,24,23,68,23,4
637,17,8,7,9,1,8,17,47.1,9,15,6,9,16,33,60,0
638,15,9,5,9,1,7,14,50,7,10,1,9,4,19,7,1
639,40,26,23,14,3,19,24,79.2,5,12,8,4,15,55,47,0
640,10,6,8,2,0,4,6,66.7,2,9,6,3,6,16,26,0
641,6,4,4,2,0,3,6,50,3,18,14,4,5,11,49,1
642,24,10,3,11,10,12,36,33.3,24,19,2,17,7,31,10,0
643,21,9,5,13,3,11,24,45.8,13,12,2,10,3,24,7,0
644,0,0,0,0,0,0,0,,0,0,0,0,0,0,0,0
645,22,11,7,14,1,12,23,52.2,11,13,3,10,4,26,6,0
646,12,6,6,3,3,8,13,61.5,5,9,3,6,4,16,18,0
647,2,2,1,0,1,2,5,40,3,5,5,0,2,4,17,0
648,22,16,8,14,0,11,32,34.4,21,24,5,19,18,40,32,0
649,13,8,10,3,0,4,12,33.3,8,14,12,2,6,19,65,0
650,8,6,4,2,2,3,5,60,2,5,0,5,1,9,4,0
651,0,0,0,0,0,0,0,,0,0,0,0,1,1,0,0
652,35,21,8,17,10,14,47,29.8,33,22,5,17,13,48,10,0
653,24,14,8,9,7,9,22,40.9,13,11,1,10,8,32,4,0
654,0,0,0,0,0,0,0,,0,0,0,0,0,0,0,0
655,23,13,14,4,5,12,22,54.5,10,8,3,5,14,37,7,0
656,4,2,0,4,0,3,5,60,2,3,2,1,4,8,3,0
657,6,3,3,2,1,3,8,37.5,5,5,0,5,1,7,4,0
658,1,0,0,0,1,1,1,100,0,0,0,0,0,1,0,0
659,0,0,0,0,0,0,0,,0,0,0,0,0,0,0,0
660,2,0,1,1,0,1,2,50,1,0,0,0,1,3,7,0
661,2,1,1,1,0,0,2,0,2,2,0,2,0,2,2,0
662,2,0,1,1,0,2,2,100,0,0,0,0,1,3,0,0
663,7,4,2,3,2,4,7,57.1,3,5,0,5,2,9,6,0
664,17,11,4,7,6,4,13,30.8,9,10,1,9,0,17,2,0
665,3,1,2,1,0,0,1,0,1,1,0,1,1,4,1,0
666,6,3,3,2,1,3,9,33.3,6,0,0,0,1,7,1,0
667,39,27,29,10,0,25,35,71.4,10,23,7,16,22,61,55,1
668,28,14,12,13,3,15,27,55.6,12,19,4,15,13,41,6,0
669,28,13,8,11,9,9,18,50,9,27,4,23,14,42,29,0
670,0,0,0,0,0,0,1,0,1,1,0,1,0,0,0,0
671,2,1,1,1,0,0,0,,0,4,2,2,8,10,19,1
672,61,30,22,29,10,31,76,40.8,45,24,4,20,10,71,26,1
673,11,4,8,2,1,7,13,53.8,6,11,3,8,6,17,6,0
674,4,2,0,3,1,2,3,66.7,1,2,0,2,9,13,4,0
675,15,10,5,4,6,7,16,43.8,9,13,1,12,2,17,6,0
676,36,21,22,10,4,18,29,62.1,11,23,6,17,12,48,23,2
677,5,3,2,3,0,3,4,75,1,1,0,1,1,6,4,0
678,0,0,0,0,0,0,0,,0,0,0,0,0,0,0,0
679,0,0,0,0,0,0,1,0,1,0,0,0,0,0,0,0
680,0,0,0,0,0,0,0,,0,0,0,0,0,0,0,0
681,58,31,30,20,8,34,53,64.2,19,30,5,25,33,91,36,1
682,10,3,3,4,3,2,5,40,3,14,2,12,3,13,5,0
683,12,6,3,5,4,3,4,75,1,1,0,1,4,16,2,0
684,1,1,0,1,0,0,0,,0,2,0,2,1,2,4,0
685,8,5,5,1,2,5,15,33.3,10,8,1,7,2,10,1,0
686,49,28,13,31,5,18,45,40,27,53,11,42,26,75,18,0
687,0,0,0,0,0,0,0,,0,0,0,0,0,0,0,0
688,23,14,7,9,7,7,15,46.7,8,13,0,13,6,29,12,0
689,0,0,0,0,0,0,1,0,1,0,0,0,3,3,15,2
690,49,24,28,15,6,20,39,51.3,19,26,7,19,23,72,51,0
691,7,4,2,4,1,2,15,13.3,13,8,0,8,5,12,0,0
692,10,4,3,4,3,1,6,16.7,5,4,0,4,4,14,18,1
693,12,7,3,8,1,7,14,50,7,6,0,6,4,16,3,0
694,20,10,12,8,0,9,14,64.3,5,28,16,12,12,32,59,1
695,43,29,19,18,6,24,43,55.8,19,27,5,22,12,55,45,0
696,3,3,3,0,0,2,3,66.7,1,0,0,0,5,8,6,0
697,6,5,5,1,0,1,3,33.3,2,4,3,1,7,13,18,0
698,1,0,1,0,0,0,0,,0,1,1,0,0,1,1,0
699,14,7,5,6,3,6,11,54.5,5,17,3,14,11,25,13,0
700,24,14,13,10,1,8,12,66.7,4,11,1,10,6,30,10,0
701,33,24,23,8,2,23,45,51.1,22,21,10,11,25,58,36,1
702,2,1,2,0,0,1,2,50,1,2,0,2,0,2,0,0
703,18,13,8,8,2,12,18,66.7,6,13,1,12,9,27,10,0
704,19,9,9,8,2,8,14,57.1,6,21,7,14,17,36,22,1
705,24,16,13,9,2,11,28,39.3,17,13,1,12,20,44,8,0
706,3,0,2,1,0,1,5,20,4,6,1,5,1,4,2,0
707,18,11,9,8,1,8,12,66.7,4,17,10,7,17,35,45,0
708,25,17,4,13,8,11,24,45.8,13,25,1,24,14,39,8,0
709,0,0,0,0,0,0,4,0,4,0,0,0,2,2,11,4
710,23,11,4,16,3,3,9,33.3,6,9,0,9,5,28,5,0
711,10,8,2,7,1,3,7,42.9,4,6,0,6,2,12,0,0
712,0,0,0,0,0,0,0,,0,0,0,0,0,0,0,0
713,4,4,2,1,1,3,4,75,1,5,1,4,0,4,0,0
714,16,9,4,11,1,3,10,30,7,5,0,5,2,18,4,0
715,23,15,14,7,2,7,15,46.7,8,32,21,11,32,55,101,2
716,2,1,0,2,0,1,4,25,3,4,1,3,0,2,2,0
717,26,10,18,8,0,17,27,63,10,14,5,9,15,41,37,0
718,25,19,6,14,5,9,17,52.9,8,15,4,11,15,40,20,0
719,1,0,1,0,0,1,1,100,0,2,0,2,1,2,13,3
720,25,16,13,12,0,14,24,58.3,10,12,4,8,8,33,12,0
721,1,1,0,1,0,0,2,0,2,0,0,0,0,1,0,0
722,4,4,2,0,2,1,4,25,3,2,0,2,0,4,1,0
723,34,20,20,13,1,24,38,63.2,14,19,11,8,36,70,58,1
724,1,0,0,1,0,1,3,33.3,2,2,0,2,0,1,1,0
725,5,2,2,1,2,3,7,42.9,4,4,0,4,3,8,1,0
726,23,16,15,7,1,12,24,50,12,20,14,6,27,50,54,0
727,18,10,8,6,4,6,15,40,9,13,2,11,11,29,4,0
728,0,0,0,0,0,0,0,,0,0,0,0,1,1,0,0
729,2,0,2,0,0,1,3,33.3,2,0,0,0,1,3,10,5
730,25,17,11,10,4,13,25,52,12,42,25,17,51,76,94,1
731,0,0,0,0,0,0,0,,0,0,0,0,0,0,0,0
732,31,21,23,7,1,13,20,65,7,17,11,6,23,54,60,1
733,23,16,15,8,0,14,26,53.8,12,19,9,10,32,55,67,1
734,17,9,11,5,1,9,20,45,11,13,2,11,11,28,6,0
735,37,19,26,10,1,13,24,54.2,11,20,10,10,28,65,58,0
736,46,29,31,15,0,22,39,56.4,17,36,13,23,60,106,117,3
737,23,14,15,8,0,12,16,75,4,10,5,5,19,42,40,1
738,1,0,0,0,1,1,2,50,1,0,0,0,0,1,1,0
739,0,0,0,0,0,0,0,,0,0,0,0,0,0,4,0
740,0,0,0,0,0,0,0,,0,0,0,0,0,0,1,0
741,3,2,1,2,0,1,1,100,0,1,0,1,0,3,0,0
742,51,22,15,26,10,24,48,50,24,34,1,33,11,62,8,0
743,28,16,13,11,4,16,32,50,16,21,2,19,21,49,32,0
744,28,18,16,12,0,12,19,63.2,7,20,9,11,22,50,69,0
745,16,10,12,3,1,8,10,80,2,11,6,5,8,24,14,1
746,0,0,0,0,0,0,0,,0,1,0,1,0,0,0,0
747,18,7,5,7,6,5,15,33.3,10,24,6,18,10,28,12,1
748,13,10,4,5,4,8,16,50,8,6,0,6,4,17,2,0
749,1,0,0,1,0,1,3,33.3,2,0,0,0,0,1,5,0
750,6,5,0,4,2,4,5,80,1,5,2,3,0,6,2,0
751,0,0,0,0,0,0,0,,0,0,0,0,0,0,1,0
752,57,36,26,24,7,29,57,50.9,28,19,2,17,13,70,18,1
753,3,1,2,1,0,2,3,66.7,1,3,2,1,5,8,4,1
754,4,1,1,1,2,3,6,50,3,3,1,2,4,8,8,0
755,2,1,0,1,1,1,1,100,0,0,0,0,0,2,0,0
756,1,0,0,1,0,1,1,100,0,0,0,0,0,1,0,0
757,0,0,0,0,0,0,1,0,1,0,0,0,0,0,9,2
758,12,6,4,8,0,4,7,57.1,3,4,1,3,1,13,2,0
759,39,23,23,12,4,14,21,66.7,7,42,24,18,25,64,105,2
760,7,4,3,2,2,4,4,100,0,2,1,1,1,8,0,0
761,3,0,2,0,1,3,4,75,1,2,0,2,2,5,4,0
762,19,11,5,10,4,9,27,33.3,18,18,2,16,9,28,7,0
763,69,43,38,28,3,27,48,56.3,21,35,11,24,49,118,33,0
764,2,2,2,0,0,1,1,100,0,0,0,0,1,3,0,0
765,36,18,10,22,4,13,31,41.9,18,17,1,16,12,48,2,0
766,0,0,0,0,0,0,0,,0,0,0,0,0,0,0,0
767,30,12,15,13,2,13,23,56.5,10,17,7,10,22,52,40,0
768,23,11,6,11,6,9,26,34.6,17,12,1,11,12,35,1,0
769,43,29,29,13,1,17,31,54.8,14,19,2,17,26,69,27,1
770,11,7,3,7,1,3,6,50,3,11,1,10,4,15,3,0
771,1,0,1,0,0,1,5,20,4,0,0,0,0,1,15,3
772,5,4,0,4,1,2,3,66.7,1,0,0,0,1,6,1,0
773,6,5,2,2,2,2,8,25,6,9,1,8,1,7,6,0
774,19,14,10,7,2,5,16,31.3,11,15,1,14,4,23,9,0
775,26,18,21,5,0,19,26,73.1,7,24,19,5,36,62,125,0
776,0,0,0,0,0,0,1,0,1,0,0,0,0,0,0,0
777,7,3,1,4,2,2,12,16.7,10,7,0,7,6,13,35,1
778,19,13,6,11,2,8,13,61.5,5,10,0,10,10,29,5,0
779,9,8,2,5,2,4,11,36.4,7,7,1,6,2,11,3,0
780,0,0,0,0,0,0,0,,0,0,0,0,0,0,0,0
781,2,1,0,1,1,1,2,50,1,3,0,3,0,2,5,0
782,24,11,11,10,3,15,26,57.7,11,28,8,20,12,36,22,0
783,12,7,0,12,0,8,15,53.3,7,5,0,5,4,16,6,0
784,20,12,15,4,1,8,20,40,12,26,18,8,27,47,67,0
785,0,0,0,0,0,0,0,,0,0,0,0,0,0,8,3
786,0,0,0,0,0,0,1,0,1,0,0,0,1,1,1,0
787,0,0,0,0,0,0,0,,0,2,1,1,1,1,2,0
788,11,8,1,6,4,5,13,38.5,8,8,1,7,2,13,7,1
789,56,33,34,18,4,34,55,61.8,21,26,5,21,19,75,48,0
790,14,4,1,8,5,8,24,33.3,16,11,0,11,8,22,4,0
791,2,2,0,2,0,0,4,0,4,14,1,13,3,5,23,0
792,1,1,1,0,0,0,1,0,1,2,0,2,0,1,0,0
793,11,8,6,5,0,2,6,33.3,4,3,0,3,1,12,4,0
794,15,9,11,4,0,9,13,69.2,4,27,6,21,11,26,29,0
795,15,9,6,6,3,6,9,66.7,3,17,10,7,7,22,51,1
796,2,1,2,0,0,1,2,50,1,0,0,0,1,3,9,2
797,56,31,16,34,6,24,47,51.1,23,41,4,37,25,81,20,0
798,23,12,7,11,5,7,11,63.6,4,14,5,9,3,26,19,0
799,15,8,5,9,1,3,7,42.9,4,6,0,6,6,21,6,0
800,39,20,14,19,6,15,30,50,15,31,6,25,28,67,18,0
801,12,10,4,5,3,4,6,66.7,2,2,0,2,1,13,1,0
802,11,8,4,6,1,5,16,31.3,11,9,3,6,5,16,15,0
803,39,26,23,11,5,26,39,66.7,13,13,2,11,8,47,33,1
804,0,0,0,0,0,0,0,,0,1,0,1,2,2,1,0
805,4,3,1,3,0,1,4,25,3,3,0,3,2,6,0,0
806,27,17,11,16,0,13,35,37.1,22,17,1,16,19,46,31,0
807,10,4,1,8,1,4,12,33.3,8,11,0,11,6,16,2,0
808,0,0,0,0,0,0,0,,0,0,0,0,0,0,0,0
809,3,0,0,2,1,1,2,50,1,4,0,4,2,5,4,0
810,4,3,1,2,1,1,7,14.3,6,1,0,1,1,5,2,0
811,4,2,1,3,0,0,3,0,3,2,1,1,2,6,0,0
812,22,14,6,10,6,6,29,20.7,23,25,1,24,14,36,7,0
813,15,8,5,7,3,7,11,63.6,4,7,1,6,11,26,4,0
814,1,1,1,0,0,1,1,100,0,0,0,0,0,1,0,0
815,21,12,12,8,1,11,18,61.1,7,12,6,6,18,39,31,1
816,43,22,30,11,2,26,32,81.3,6,22,9,13,29,72,118,3
817,19,13,15,4,0,11,17,64.7,6,32,24,8,24,43,143,0
818,7,3,2,3,2,3,8,37.5,5,10,2,8,3,10,4,0
819,37,23,14,20,3,15,38,39.5,23,33,2,31,21,58,33,0
820,35,18,11,22,2,12,24,50,12,14,0,14,7,42,5,0
821,1,0,0,1,0,1,1,100,0,1,0,1,0,1,0,0
822,15,9,2,7,6,5,9,55.6,4,13,3,10,5,20,12,0
823,42,26,28,11,3,20,32,62.5,12,15,3,12,12,54,58,0
824,14,8,3,7,4,4,11,36.4,7,5,1,4,3,17,12,0
825,54,31,23,25,6,27,61,44.3,34,34,6,28,23,77,52,0
826,18,7,8,9,1,8,13,61.5,5,11,3,8,10,28,7,0
827,12,10,7,3,2,5,22,22.7,17,17,7,10,8,20,18,1
828,20,10,14,5,1,9,18,50,9,29,18,11,25,45,89,1
829,16,8,8,8,0,10,13,76.9,3,7,1,6,10,26,4,0
830,26,15,11,14,1,11,18,61.1,7,7,2,5,9,35,17,0
831,25,17,17,7,1,11,27,40.7,16,17,4,13,14,39,33,0
832,69,43,39,19,11,38,73,52.1,35,42,10,32,32,101,75,0
833,4,0,1,3,0,2,5,40,3,12,7,5,5,9,41,2
834,5,5,3,2,0,3,10,30,7,3,0,3,3,8,5,0
835,23,12,16,5,2,12,16,75,4,25,15,10,31,54,73,0
836,44,24,25,13,6,27,42,64.3,15,20,6,14,30,74,28,0
837,10,4,10,0,0,6,10,60,4,6,5,1,16,26,33,0
838,31,18,15,14,2,11,18,61.1,7,7,0,7,10,41,20,0
839,31,18,13,12,6,9,23,39.1,14,20,0,20,9,40,6,0
840,17,9,8,4,5,8,13,61.5,5,6,0,6,5,22,2,1
841,18,12,8,7,3,7,15,46.7,8,15,0,15,3,21,4,0
842,2,0,2,0,0,1,2,50,1,0,0,0,0,2,7,1
843,46,26,15,27,4,17,46,37,29,29,10,19,28,74,25,0
844,4,2,1,2,1,4,6,66.7,2,2,0,2,3,7,11,0
845,27,19,16,8,3,13,25,52,12,15,7,8,24,51,18,0
846,45,26,21,22,2,23,37,62.2,14,42,30,12,34,79,76,2
847,1,1,1,0,0,1,2,50,1,6,3,3,7,8,19,0
848,19,12,7,10,2,7,20,35,13,10,2,8,8,27,6,0
849,1,0,1,0,0,1,1,100,0,0,0,0,0,1,7,2
850,10,6,2,4,4,3,11,27.3,8,7,0,7,0,10,3,0
851,6,3,2,2,2,1,3,33.3,2,3,0,3,0,6,0,0
852,3,3,1,2,0,1,7,14.3,6,4,1,3,2,5,9,0
853,2,0,2,0,0,2,2,100,0,0,0,0,2,4,18,3
854,21,13,13,8,0,13,21,61.9,8,19,12,7,7,28,64,1
855,0,0,0,0,0,0,0,,0,1,0,1,0,0,1,0
856,22,14,10,10,2,10,29,34.5,19,18,4,14,9,31,21,0
857,13,8,6,3,4,4,16,25,12,16,0,16,3,16,5,0
858,29,14,11,16,2,12,19,63.2,7,6,1,5,6,35,4,0
859,0,0,0,0,0,0,0,,0,0,0,0,1,1,0,0
860,15,12,8,7,0,4,11,36.4,7,9,4,5,28,43,61,0
861,25,14,16,7,2,14,24,58.3,10,10,2,8,7,32,18,0
862,4,2,1,3,0,3,4,75,1,9,9,0,5,9,27,0
863,11,5,3,3,5,2,9,22.2,7,6,2,4,1,12,0,0
864,23,11,14,9,0,16,25,64,9,20,8,12,20,43,55,0
865,3,2,1,2,0,2,4,50,2,2,2,0,0,3,7,0
866,22,14,12,10,0,13,26,50,13,31,19,12,21,43,62,0
867,13,6,4,6,3,4,11,36.4,7,3,0,3,1,14,0,1
868,10,7,2,3,5,1,6,16.7,5,1,0,1,3,13,2,0
869,24,16,12,10,2,13,21,61.9,8,17,8,9,18,42,46,1
870,10,5,8,1,1,7,11,63.6,4,11,5,6,14,24,19,0
871,6,3,1,3,2,1,5,20,4,8,1,7,1,7,4,0
872,31,19,13,14,4,15,27,55.6,12,15,5,10,16,47,15,0
873,57,34,21,21,15,26,56,46.4,30,28,5,23,19,76,37,1
874,28,20,21,4,3,13,23,56.5,10,35,15,20,43,71,62,2
875,1,1,1,0,0,0,1,0,1,0,0,0,1,2,10,0
876,12,6,6,3,3,4,12,33.3,8,14,1,13,7,19,16,0
877,0,0,0,0,0,0,0,,0,0,0,0,0,0,7,2
878,4,3,1,2,1,0,8,0,8,1,0,1,1,5,2,0
879,33,22,21,10,2,15,41,36.6,26,22,2,20,11,44,8,0
880,1,1,1,0,0,1,1,100,0,0,0,0,2,3,12,0
881,25,23,17,7,1,12,19,63.2,7,26,18,8,19,44,84,1
882,0,0,0,0,0,0,2,0,2,2,0,2,0,0,14,2
883,25,17,10,12,3,12,18,66.7,6,16,7,9,19,44,25,0
884,9,5,7,2,0,4,8,50,4,21,10,11,19,28,25,0
885,30,18,26,4,0,21,29,72.4,8,13,3,10,19,49,33,1
886,2,1,0,2,0,1,1,100,0,1,1,0,1,3,2,0
887,46,31,27,15,4,25,66,37.9,41,17,6,11,20,66,15,0
888,10,7,5,5,0,2,21,9.5,19,6,0,6,3,13,1,0
889,0,0,0,0,0,0,0,,0,0,0,0,1,1,1,0
890,16,12,2,11,3,3,17,17.6,14,15,1,14,6,22,2,0
891,37,19,21,11,5,20,37,54.1,17,18,6,12,19,56,26,0
892,8,5,3,3,2,5,9,55.6,4,5,0,5,5,13,14,0
893,0,0,0,0,0,0,1,0,1,0,0,0,0,0,6,3
894,12,3,7,5,0,4,14,28.6,10,9,3,6,4,16,18,0
895,37,22,12,14,11,18,47,38.3,29,31,5,26,23,60,10,0
896,4,2,2,1,1,3,5,60,2,0,0,0,1,5,2,0
897,14,8,8,4,2,7,13,53.8,6,17,1,16,5,19,8,0
898,2,1,0,1,1,0,0,,0,1,0,1,0,2,0,0
899,21,8,5,15,1,9,29,31,20,12,3,9,18,39,9,0
900,4,2,1,2,1,1,3,33.3,2,1,1,0,9,13,5,0
901,19,12,11,4,4,7,11,63.6,4,11,6,5,16,35,20,0
902,0,0,0,0,0,0,0,,0,0,0,0,1,1,1,1
903,64,31,26,33,5,31,59,52.5,28,34,3,31,35,99,27,0
904,29,18,13,10,6,15,34,44.1,19,14,6,8,23,52,18,2
905,21,16,18,2,1,10,20,50,10,22,11,11,20,41,84,2
906,22,9,6,8,8,9,28,32.1,19,13,2,11,11,33,8,0
907,14,11,1,6,7,6,18,33.3,12,21,1,20,3,17,6,0
908,2,1,0,2,0,1,6,16.7,5,3,0,3,0,2,1,0
909,0,0,0,0,0,0,0,,0,0,0,0,0,0,2,0
910,25,17,10,11,4,8,32,25,24,20,0,20,4,29,4,0
911,0,0,0,0,0,0,0,,0,0,0,0,0,0,0,0
912,7,5,3,3,1,4,4,100,0,2,0,2,0,7,1,0
913,22,13,12,7,3,14,18,77.8,4,17,3,14,7,29,23,0
914,57,35,38,17,2,33,45,73.3,12,23,9,14,14,71,51,0
915,10,6,6,4,0,3,5,60,2,2,1,1,2,12,5,0
916,0,0,0,0,0,0,0,,0,0,0,0,0,0,1,0
917,4,2,2,2,0,0,2,0,2,4,1,3,5,9,4,0
918,64,41,30,27,7,34,64,53.1,30,27,4,23,34,98,32,2
919,2,2,0,0,2,2,5,40,3,3,1,2,0,2,3,0
920,50,27,18,26,6,17,32,53.1,15,19,3,16,12,62,36,0
921,0,0,0,0,0,0,0,,0,0,0,0,0,0,0,0
922,39,24,22,14,3,10,30,33.3,20,32,1,31,15,54,15,0
923,3,2,2,0,1,1,4,25,3,7,2,5,1,4,27,0
924,36,26,22,12,2,23,35,65.7,12,24,4,20,14,50,42,0
925,41,21,23,15,3,17,39,43.6,22,35,9,26,27,68,42,0
926,11,5,2,6,3,3,12,25,9,5,0,5,1,12,1,0
927,44,31,29,15,0,27,48,56.3,21,35,13,22,49,93,93,1
928,13,9,10,2,1,8,10,80,2,9,4,5,11,24,39,0
929,45,22,20,22,3,18,35,51.4,17,19,2,17,12,57,35,0
930,33,13,14,14,5,22,39,56.4,17,27,2,25,7,40,10,0
931,9,3,2,3,4,4,10,40,6,6,0,6,5,14,1,0
932,6,5,2,3,1,5,12,41.7,7,5,0,5,5,11,7,0
933,9,4,0,6,3,3,12,25,9,12,4,8,1,10,24,0
934,17,10,12,5,0,6,8,75,2,8,3,5,5,22,28,0
935,11,6,3,4,4,2,11,18.2,9,10,1,9,3,14,20,0
936,3,2,1,2,0,0,0,,0,1,0,1,0,3,0,0
937,14,5,7,6,1,9,18,50,9,7,2,5,1,15,8,0
938,5,3,0,3,2,1,4,25,3,3,1,2,2,7,6,1
939,11,7,2,6,3,5,19,26.3,14,7,1,6,2,13,1,0
940,81,58,49,29,3,35,73,47.9,38,42,3,39,29,110,49,1
941,47,32,23,21,3,17,42,40.5,25,22,7,15,23,70,17,0
942,8,6,5,1,2,4,17,23.5,13,7,1,6,3,11,2,0
943,33,22,15,11,7,8,25,32,17,27,5,22,15,48,16,0
944,46,28,29,10,7,31,42,73.8,11,27,3,24,11,57,46,0
945,2,2,2,0,0,2,3,66.7,1,0,0,0,2,4,14,0
946,37,20,26,10,1,17,25,68,8,17,6,11,14,51,31,1
947,18,9,5,10,3,7,21,33.3,14,9,1,8,8,26,0,0
948,73,44,37,26,10,22,46,47.8,24,40,8,32,48,121,25,3
949,8,6,2,2,4,4,7,57.1,3,10,0,10,2,10,11,0
950,0,0,0,0,0,0,0,,0,0,0,0,0,0,1,0
951,2,2,0,1,1,0,0,,0,0,0,0,0,2,3,0
952,33,17,8,16,9,13,30,43.3,17,23,8,15,30,63,32,1
953,37,21,15,8,14,6,20,30,14,27,3,24,23,60,16,1
954,9,4,6,2,1,2,9,22.2,7,3,1,2,5,14,6,1
955,0,0,0,0,0,0,0,,0,0,0,0,0,0,2,0
956,33,19,11,18,4,21,32,65.6,11,11,4,7,14,47,20,1
957,30,16,20,10,0,17,20,85,3,21,9,12,34,64,118,0
958,18,11,12,4,2,6,9,66.7,3,19,9,10,16,34,31,1
959,53,34,36,10,7,33,56,58.9,23,31,6,25,34,87,44,0
960,10,7,2,3,5,4,12,33.3,8,8,1,7,5,15,9,0
961,13,5,8,4,1,6,18,33.3,12,12,1,11,8,21,9,0
962,20,11,11,7,2,10,14,71.4,4,20,12,8,18,38,56,2
963,3,1,0,0,3,1,8,12.5,7,5,0,5,4,7,2,0
964,7,6,1,5,1,2,5,40,3,2,0,2,5,12,1,0
965,1,0,0,1,0,0,0,,0,1,1,0,1,2,4,0
966,2,1,1,0,1,1,1,100,0,1,0,1,0,2,0,0
967,0,0,0,0,0,0,0,,0,0,0,0,0,0,0,0
968,47,26,22,19,6,31,81,38.3,50,26,6,20,24,71,20,1
969,8,5,6,1,1,4,6,66.7,2,11,7,4,14,22,35,1
970,40,25,6,25,9,19,45,42.2,26,27,4,23,17,57,19,0
971,0,0,0,0,0,0,1,0,1,0,0,0,1,1,6,4
972,0,0,0,0,0,0,0,,0,0,0,0,0,0,11,1
973,35,20,13,21,1,16,29,55.2,13,22,3,19,15,50,12,1
974,6,2,1,3,2,3,5,60,2,5,0,5,0,6,4,0
975,71,43,47,17,7,31,57,54.4,26,40,4,36,34,105,68,0
976,15,6,5,7,3,4,13,30.8,9,7,0,7,3,18,7,0
977,25,14,8,10,7,10,24,41.7,14,23,3,20,6,31,22,0
978,10,8,2,3,5,3,10,30,7,8,0,8,6,16,11,0
979,6,4,1,4,1,3,5,60,2,5,0,5,2,8,4,0
980,0,0,0,0,0,0,2,0,2,1,0,1,3,3,0,0
981,13,9,9,3,1,8,16,50,8,9,4,5,4,17,11,0
982,2,1,0,1,1,1,2,50,1,3,1,2,3,5,2,0
983,2,2,1,0,1,2,4,50,2,4,2,2,4,6,11,1
984,3,1,3,0,0,2,3,66.7,1,2,0,2,1,4,3,0
985,20,11,6,4,10,8,22,36.4,14,15,3,12,10,30,12,0
986,21,11,9,9,3,13,31,41.9,18,17,5,12,9,30,28,0
987,35,19,18,15,2,8,11,72.7,3,21,7,14,42,77,69,1
988,2,2,2,0,0,2,3,66.7,1,0,0,0,0,2,15,5
989,0,0,0,0,0,0,0,,0,0,0,0,0,0,1,0
990,46,25,26,14,6,23,42,54.8,19,36,12,24,25,71,42,1
991,3,1,3,0,0,0,1,0,1,0,0,0,3,6,3,0
992,1,0,0,1,0,1,7,14.3,6,1,0,1,1,2,3,0
993,0,0,0,0,0,0,1,0,1,0,0,0,0,0,0,0
994,3,1,0,2,1,1,2,50,1,0,0,0,0,3,1,0
995,37,17,24,11,2,22,35,62.9,13,30,18,12,33,70,116,3
996,101,60,62,34,5,60,107,56.1,47,44,18,26,64,165,150,1
997,7,5,2,3,2,1,7,14.3,6,10,3,7,2,9,19,0
998,23,15,7,8,8,9,21,42.9,12,20,1,19,8,31,4,1
999,22,15,6,12,4,9,24,37.5,15,17,1,16,4,26,7,0
1000,18,10,13,3,2,9,22,40.9,13,10,4,6,7,25,28,1
1001,1,0,1,0,0,1,1,100,0,0,0,0,0,1,2,0
1002,0,0,0,0,0,0,0,,0,0,0,0,0,0,0,0
1003,52,28,16,27,9,22,60,36.7,38,25,0,25,31,83,10,0
1004,30,16,10,14,6,14,44,31.8,30,18,5,13,9,39,15,1
1005,35,18,11,16,8,16,41,39,25,18,2,16,12,47,10,1
1006,15,6,7,7,1,6,10,60,4,5,2,3,2,17,6,0
1007,8,5,5,3,0,4,5,80,1,12,6,6,6,14,33,0
1008,2,1,1,1,0,1,1,100,0,0,0,0,1,3,0,0
1009,28,21,15,11,2,11,19,57.9,8,16,11,5,22,50,50,2
1010,0,0,0,0,0,0,0,,0,0,0,0,0,0,2,0
1011,22,15,6,14,2,13,28,46.4,15,14,3,11,8,30,4,1
1012,5,4,2,3,0,1,3,33.3,2,4,1,3,4,9,5,0
1013,20,11,14,6,0,13,16,81.3,3,22,10,12,20,40,90,0
1014,5,2,3,1,1,2,3,66.7,1,4,2,2,2,7,4,0
1015,33,20,14,16,3,12,33,36.4,21,12,1,11,12,45,5,1
1016,12,7,9,3,0,7,11,63.6,4,14,12,2,7,19,50,1
1017,22,15,13,6,3,11,19,57.9,8,10,8,2,19,41,94,0
1018,16,8,11,2,3,9,21,42.9,12,6,2,4,7,23,20,0
1019,44,25,19,17,8,16,47,34,31,36,8,28,14,58,27,0
1020,9,4,2,5,2,1,8,12.5,7,10,0,10,2,11,4,0
1021,14,8,5,6,3,5,13,38.5,8,9,3,6,9,23,8,0
1022,40,20,25,11,4,19,29,65.5,10,25,9,16,39,79,54,0
1023,0,0,0,0,0,0,1,0,1,0,0,0,1,1,0,0
1024,6,3,3,3,0,4,6,66.7,2,4,0,4,3,9,5,0
1025,11,9,4,5,2,7,14,50,7,3,0,3,1,12,0,1
1026,34,22,17,10,7,8,23,34.8,15,19,0,19,4,38,11,0
1027,36,22,19,11,6,22,39,56.4,17,35,3,32,24,60,26,0
1028,30,16,17,6,7,18,25,72,7,14,0,14,9,39,15,0
1029,27,15,12,8,7,14,19,73.7,5,12,1,11,17,44,11,0
1030,35,20,12,16,7,9,35,25.7,26,19,0,19,13,48,7,0
1031,1,1,1,0,0,0,1,0,1,1,0,1,0,1,3,0
1032,28,16,8,11,9,4,18,22.2,14,15,0,15,6,34,6,0
1033,40,25,17,17,6,23,45,51.1,22,37,23,14,45,85,115,2
1034,35,23,15,14,6,17,32,53.1,15,25,15,10,30,65,56,0
1035,15,7,9,5,1,5,9,55.6,4,9,4,5,7,22,18,0
1036,18,16,9,9,0,10,13,76.9,3,13,8,5,19,37,29,0
1037,10,6,1,8,1,5,10,50,5,4,1,3,4,14,5,0
1038,3,3,0,3,0,0,0,,0,4,2,2,9,12,15,0
1039,16,8,9,6,1,8,13,61.5,5,18,9,9,21,37,36,0
1040,25,19,5,12,8,14,25,56,11,18,3,15,11,36,16,0
1041,0,0,0,0,0,0,1,0,1,3,0,3,0,0,0,0
1042,0,0,0,0,0,0,0,,0,0,0,0,0,0,3,0
1043,21,13,8,11,2,11,17,64.7,6,16,2,14,6,27,7,0
1044,11,7,7,4,0,5,15,33.3,10,9,2,7,1,12,1,0
1045,19,12,6,9,4,3,20,15,17,20,3,17,5,24,10,0
1046,5,2,1,3,1,5,11,45.5,6,7,3,4,2,7,15,0
1047,17,8,4,11,2,7,15,46.7,8,9,1,8,6,23,7,0
1048,38,27,7,21,10,13,48,27.1,35,29,3,26,16,54,17,0
1049,22,13,5,9,8,9,24,37.5,15,9,1,8,12,34,14,0
1050,0,0,0,0,0,0,1,0,1,0,0,0,0,0,1,1
1051,45,20,13,30,2,24,50,48,26,17,5,12,19,64,35,1
1052,44,26,17,22,5,20,42,47.6,22,26,8,18,12,56,14,1
1053,0,0,0,0,0,0,0,,0,0,0,0,0,0,0,0
1054,37,23,12,22,3,17,28,60.7,11,20,5,15,19,56,17,1
1055,21,12,12,9,0,9,16,56.3,7,13,4,9,10,31,15,0
1056,0,0,0,0,0,0,0,,0,0,0,0,0,0,9,1
1057,31,19,13,17,1,14,33,42.4,19,12,5,7,16,47,22,0
1058,12,7,6,5,1,2,4,50,2,6,0,6,2,14,7,0
1059,5,4,0,3,2,2,7,28.6,5,5,0,5,0,5,3,0
1060,32,25,17,13,2,14,23,60.9,9,33,24,9,24,56,83,1
1061,16,10,7,8,1,9,16,56.3,7,8,2,6,9,25,13,0
1062,8,6,4,3,1,5,8,62.5,3,4,0,4,1,9,2,0
1063,0,0,0,0,0,0,0,,0,1,0,1,0,0,0,0
1064,43,21,33,9,1,21,34,61.8,13,41,23,18,38,81,109,3
1065,34,16,8,19,7,12,32,37.5,20,10,4,6,21,55,15,0
1066,30,15,12,12,6,18,30,60,12,15,1,14,29,59,16,0
1067,22,16,8,11,3,6,12,50,6,17,1,16,7,29,6,0
1068,5,2,2,2,1,1,2,50,1,5,1,4,2,7,3,0
1069,21,12,6,13,2,9,19,47.4,10,14,4,10,14,35,7,0
1070,18,7,10,7,1,7,15,46.7,8,9,2,7,9,27,2,0
1071,12,8,2,9,1,4,15,26.7,11,12,7,5,12,24,26,0
1072,21,14,10,7,4,13,23,56.5,10,9,1,8,24,45,19,1
1073,20,12,10,8,2,8,24,33.3,16,13,2,11,19,39,30,2
1074,55,26,20,30,5,23,45,51.1,22,24,4,20,25,80,15,1
1075,0,0,0,0,0,0,0,,0,0,0,0,0,0,0,0
1076,2,1,1,1,0,1,1,100,0,6,1,5,0,2,10,0
1077,0,0,0,0,0,0,0,,0,0,0,0,0,0,1,0
1078,0,0,0,0,0,0,0,,0,0,0,0,0,0,2,0
1079,9,6,7,2,0,1,1,100,0,5,1,4,12,21,19,0
1080,34,18,15,18,1,14,39,35.9,25,25,7,18,21,55,30,0
1081,32,22,13,15,4,10,24,41.7,14,19,7,12,22,54,55,1
1082,26,16,6,10,10,11,28,39.3,17,15,3,12,17,43,12,0
1083,25,17,15,8,2,11,38,28.9,27,15,4,11,14,39,30,0
1084,10,6,1,8,1,4,7,57.1,3,24,15,9,30,40,46,0
1085,5,4,3,2,0,4,5,80,1,4,2,2,3,8,16,0
1086,15,13,4,7,4,7,13,53.8,6,13,2,11,4,19,4,0
1087,34,21,17,10,7,15,33,45.5,18,21,4,17,24,58,21,1
1088,16,10,7,8,1,8,18,44.4,10,8,2,6,7,23,6,0
1089,27,15,17,7,3,12,17,70.6,5,18,2,16,14,41,29,1
1090,19,13,13,6,0,7,17,41.2,10,33,16,17,28,47,70,1
1091,2,2,1,1,0,0,0,,0,2,0,2,0,2,0,0
1092,14,8,6,7,1,6,25,24,19,21,6,15,8,22,20,0
1093,24,18,18,5,1,11,17,64.7,6,26,18,8,29,53,70,0
1094,6,2,1,4,1,2,5,40,3,3,1,2,0,6,1,0
1095,3,2,0,2,1,1,4,25,3,9,3,6,2,5,11,0
1096,23,11,12,6,5,10,21,47.6,11,13,4,9,7,30,22,0
1097,22,14,6,13,3,14,40,35,26,28,1,27,11,33,19,0
1098,29,17,20,9,0,18,32,56.3,14,16,5,11,24,53,45,1
1099,9,5,3,4,2,2,5,40,3,19,2,17,7,16,5,0
1100,21,16,10,8,3,12,21,57.1,9,8,2,6,9,30,11,0
1101,2,2,1,1,0,1,1,100,0,0,0,0,0,2,3,0
1102,9,5,4,4,1,8,12,66.7,4,9,2,7,4,13,14,0
1103,19,9,11,8,0,9,27,33.3,18,21,4,17,20,39,13,0
1104,21,14,8,8,5,9,18,50,9,22,7,15,30,51,28,0
1105,46,27,17,17,12,27,46,58.7,19,29,1,28,11,57,14,0
1106,11,3,10,1,0,8,12,66.7,4,4,0,4,10,21,5,1
1107,1,1,0,0,1,0,2,0,2,4,0,4,0,1,7,0
1108,32,18,17,10,5,18,32,56.3,14,21,1,20,15,47,22,0
1109,0,0,0,0,0,0,1,0,1,0,0,0,1,1,1,0
1110,6,2,2,2,2,2,4,50,2,4,0,4,2,8,1,0
1111,0,0,0,0,0,0,0,,0,0,0,0,0,0,0,0
1112,25,17,18,4,3,16,27,59.3,11,10,5,5,23,48,45,2
1113,0,0,0,0,0,0,0,,0,0,0,0,0,0,3,0
1114,15,7,6,7,2,3,13,23.1,10,13,2,11,8,23,5,0
1115,12,8,1,10,1,3,9,33.3,6,7,1,6,3,15,9,0
1116,6,4,0,3,3,3,8,37.5,5,4,1,3,4,10,6,0
1117,0,0,0,0,0,0,0,,0,0,0,0,0,0,0,0
1118,34,15,2,15,17,11,40,27.5,29,34,1,33,15,49,16,0
1119,12,3,4,4,4,2,7,28.6,5,6,1,5,1,13,7,0
1120,13,8,11,2,0,5,17,29.4,12,17,7,10,9,22,31,0
1121,0,0,0,0,0,0,0,,0,0,0,0,0,0,0,0
1122,21,13,11,8,2,11,27,40.7,16,23,4,19,12,33,25,0
1123,33,15,4,19,10,9,28,32.1,19,27,0,27,7,40,37,0
1124,0,0,0,0,0,0,1,0,1,0,0,0,0,0,0,0
1125,17,6,5,11,1,12,17,70.6,5,6,0,6,5,22,5,0
1126,0,0,0,0,0,0,0,,0,0,0,0,0,0,0,0
1127,2,1,1,1,0,1,1,100,0,0,0,0,4,6,3,0
1128,78,43,44,27,7,47,81,58,34,52,6,46,32,110,53,0
1129,12,6,6,4,2,5,13,38.5,8,13,0,13,2,14,3,0
1130,21,15,11,7,3,14,31,45.2,17,9,0,9,6,27,6,0
1131,7,5,4,3,0,3,10,30,7,9,5,4,9,16,29,0
1132,0,0,0,0,0,0,0,,0,0,0,0,0,0,12,1
1133,22,15,8,10,4,9,20,45,11,16,3,13,17,39,13,0
1134,9,8,4,4,1,4,17,23.5,13,8,2,6,8,17,8,0
1135,0,0,0,0,0,0,1,0,1,2,1,1,1,1,7,0
1136,1,0,1,0,0,1,1,100,0,0,0,0,0,1,1,0
1137,63,39,35,26,2,37,55,67.3,18,41,4,37,27,90,37,0
1138,4,1,1,0,3,3,5,60,2,1,0,1,1,5,2,0
1139,40,29,21,13,6,17,40,42.5,23,16,0,16,12,52,13,0
1140,15,9,7,5,3,4,11,36.4,7,12,4,8,10,25,7,0
1141,47,26,18,21,8,18,31,58.1,13,25,7,18,22,69,69,1
1142,5,3,1,1,3,1,5,20,4,6,2,4,0,5,14,0
1143,10,4,7,2,1,4,13,30.8,9,16,11,5,20,30,48,0
1144,13,8,8,3,2,4,13,30.8,9,15,6,9,12,25,51,0
1145,11,7,9,2,0,7,14,50,7,21,13,8,17,28,51,1
1146,6,4,3,3,0,5,6,83.3,1,2,1,1,5,11,7,0
1147,23,14,17,5,1,14,23,60.9,9,22,19,3,21,44,104,0
1148,3,2,2,1,0,3,7,42.9,4,2,0,2,2,5,0,0
1149,39,22,24,14,1,20,31,64.5,11,32,7,25,13,52,24,1
1150,6,4,2,3,1,2,3,66.7,1,6,1,5,5,11,6,0
1151,2,0,2,0,0,2,2,100,0,1,0,1,1,3,5,0
1152,21,8,9,10,2,5,13,38.5,8,12,1,11,2,23,8,0
1153,6,2,4,1,1,2,4,50,2,2,0,2,2,8,0,0
1154,19,9,5,8,6,6,21,28.6,15,19,2,17,10,29,5,0
1155,34,23,24,10,0,17,30,56.7,13,13,6,7,16,50,24,0
1156,53,25,38,15,0,25,44,56.8,19,27,10,17,21,74,62,1
1157,3,2,3,0,0,1,2,50,1,1,0,1,1,4,6,0
1158,42,28,23,16,3,19,29,65.5,10,33,16,17,24,66,68,1
1159,71,39,39,32,0,28,52,53.8,24,33,9,24,61,132,48,0
1160,8,3,4,3,1,2,5,40,3,8,2,6,5,13,8,0
1161,5,2,1,3,1,3,4,75,1,5,0,5,0,5,2,1
1162,54,29,21,31,2,21,46,45.7,25,37,12,25,43,97,37,0
1163,21,11,13,7,1,9,37,24.3,28,28,2,26,14,35,16,0
1164,15,9,0,11,4,4,9,44.4,5,17,7,10,6,21,33,0
1165,5,3,3,2,0,2,2,100,0,3,2,1,2,7,19,1
1166,11,8,2,5,4,3,12,25,9,15,4,11,8,19,16,0
1167,8,4,7,1,0,3,6,50,3,7,3,4,6,14,24,0
1168,26,15,13,8,5,16,31,51.6,15,21,6,15,9,35,41,0
1169,6,4,2,2,2,2,5,40,3,0,0,0,0,6,5,0
1170,13,7,6,6,1,11,17,64.7,6,14,1,13,2,15,2,0
1171,8,5,4,4,0,5,5,100,0,7,1,6,6,14,9,0
1172,10,7,6,4,0,6,11,54.5,5,10,8,2,4,14,19,1
1173,36,25,19,7,10,18,33,54.5,15,21,1,20,18,54,17,0
1174,2,1,1,1,0,1,1,100,0,1,0,1,3,5,2,0
1175,41,30,24,15,2,13,21,61.9,8,38,20,18,44,85,109,0
1176,1,1,1,0,0,1,1,100,0,0,0,0,0,1,0,0
1177,0,0,0,0,0,0,0,,0,0,0,0,0,0,3,1
1178,6,4,2,4,0,5,8,62.5,3,4,2,2,4,10,12,0
1179,2,1,1,1,0,1,2,50,1,2,0,2,0,2,2,1
1180,38,23,31,7,0,21,41,51.2,20,22,10,12,44,82,118,0
1181,5,3,4,0,1,1,1,100,0,0,0,0,2,7,4,0
1182,17,9,7,9,1,6,12,50,6,9,4,5,9,26,2,0
1183,46,24,26,19,1,23,39,59,16,22,12,10,26,72,74,1
1184,35,18,17,13,5,13,33,39.4,20,27,0,27,5,40,7,0
1185,22,9,7,11,4,10,22,45.5,12,16,2,14,4,26,5,0
1186,0,0,0,0,0,0,0,,0,0,0,0,1,1,0,0
1187,28,14,17,7,4,15,27,55.6,12,19,6,13,12,40,35,0
1188,46,24,23,18,5,23,53,43.4,30,41,15,26,42,88,56,1
1189,4,3,0,2,2,1,3,33.3,2,8,0,8,0,4,4,0
1190,30,14,18,9,3,10,27,37,17,17,5,12,12,42,52,0
1191,21,8,4,13,4,6,22,27.3,16,13,1,12,7,28,15,0
1192,58,28,32,23,3,27,39,69.2,12,22,8,14,53,111,85,1
1193,1,1,1,0,0,0,0,,0,0,0,0,0,1,0,0
1194,0,0,0,0,0,0,0,,0,1,1,0,0,0,2,0
1195,28,18,5,16,7,10,30,33.3,20,16,0,16,11,39,18,0
1196,47,24,33,11,3,23,46,50,23,27,5,22,16,63,71,0
1197,8,4,3,3,2,2,13,15.4,11,6,1,5,1,9,15,0
1198,32,19,16,12,4,13,20,65,7,30,13,17,20,52,47,2
1199,6,2,0,3,3,3,7,42.9,4,5,1,4,0,6,7,0
1200,13,5,5,4,4,4,10,40,6,15,1,14,4,17,3,0
1201,16,10,9,7,0,6,11,54.5,5,10,1,9,8,24,14,0
1202,6,3,2,3,1,3,9,33.3,6,6,1,5,3,9,4,0
1203,3,3,0,1,2,2,4,50,2,2,0,2,1,4,1,0
1204,2,1,1,0,1,2,3,66.7,1,1,0,1,1,3,3,0
1205,1,1,0,1,0,1,1,100,0,3,1,2,2,3,2,0
1206,2,1,1,0,1,1,2,50,1,1,0,1,0,2,1,0
1207,28,13,9,15,4,12,33,36.4,21,22,6,16,13,41,15,0
1208,8,5,2,4,2,3,5,60,2,9,1,8,1,9,10,0
1209,4,3,0,3,1,1,5,20,4,4,2,2,3,7,4,0
1210,10,5,1,6,3,1,6,16.7,5,12,1,11,1,11,11,0
1211,3,1,0,1,2,1,9,11.1,8,8,1,7,2,5,9,0
1212,25,14,13,11,1,10,28,35.7,18,17,4,13,18,43,24,0
1213,10,5,1,5,4,6,16,37.5,10,13,1,12,2,12,7,0
1214,1,1,0,0,1,0,0,,0,0,0,0,0,1,2,0
1215,15,9,6,5,4,8,14,57.1,6,3,0,3,10,25,3,0
1216,38,16,14,15,9,15,26,57.7,11,21,4,17,17,55,29,0
1217,37,29,22,15,0,17,22,77.3,5,42,27,15,24,61,106,0
1218,15,9,9,4,2,7,18,38.9,11,32,20,12,21,36,73,0
1219,32,24,18,12,2,16,31,51.6,15,36,15,21,31,63,84,0
1220,34,17,12,12,10,13,46,28.3,33,24,1,23,7,41,4,0
1221,0,0,0,0,0,0,1,0,1,0,0,0,0,0,1,0
1222,0,0,0,0,0,0,0,,0,0,0,0,0,0,2,0
1223,60,34,33,24,3,29,53,54.7,24,26,1,25,18,78,24,0
1224,57,39,34,21,2,20,29,69,9,16,7,9,34,91,62,0
1225,7,6,2,5,0,1,4,25,3,10,2,8,2,9,3,0
1226,30,14,7,18,5,12,29,41.4,17,26,5,21,12,42,13,0
1227,22,17,10,11,1,15,28,53.6,13,10,5,5,15,37,35,1
1228,0,0,0,0,0,0,1,0,1,0,0,0,0,0,2,0
1229,33,21,19,12,2,22,41,53.7,19,32,10,22,12,45,49,1
1230,0,0,0,0,0,0,1,0,1,0,0,0,0,0,1,0
1231,5,2,3,2,0,2,6,33.3,4,4,1,3,4,9,9,0
1232,1,1,0,0,1,0,0,,0,0,0,0,0,1,0,0
1233,6,2,1,3,2,3,6,50,3,4,0,4,2,8,2,0
1234,7,4,3,3,1,4,8,50,4,2,1,1,1,8,4,0
1235,30,19,9,18,3,14,18,77.8,4,15,2,13,10,40,23,0
1236,46,23,18,20,8,17,35,48.6,18,20,7,13,19,65,22,0
1237,18,11,12,4,2,9,15,60,6,16,4,12,10,28,22,1
1238,5,3,4,1,0,3,5,60,2,13,9,4,9,14,38,0
1239,2,1,1,1,0,1,1,100,0,4,2,2,0,2,5,0
1240,0,0,0,0,0,0,1,0,1,0,0,0,1,1,0,0
1241,16,8,9,6,1,9,14,64.3,5,6,3,3,4,20,26,0
1242,12,8,3,4,5,4,15,26.7,11,9,2,7,1,13,4,0
1243,4,1,1,2,1,1,4,25,3,1,0,1,3,7,6,0
1244,0,0,0,0,0,0,1,0,1,1,0,1,0,0,0,0
1245,29,14,21,8,0,12,19,63.2,7,14,12,2,21,50,71,1
1246,1,0,0,1,0,1,2,50,1,2,0,2,1,2,0,0
1247,14,9,8,3,3,5,10,50,5,12,5,7,4,18,12,0
1248,60,29,23,26,11,29,82,35.4,53,49,5,44,28,88,20,1
1249,12,9,6,5,1,4,6,66.7,2,13,8,5,7,19,36,1
1250,1,0,0,1,0,0,1,0,1,1,0,1,0,1,1,0
1251,22,18,12,5,5,9,20,45,11,18,2,16,8,30,10,1
1252,10,6,5,4,1,5,7,71.4,2,15,8,7,6,16,22,0
1253,9,6,3,5,1,3,5,60,2,9,0,9,0,9,8,0
1254,1,1,0,1,0,0,2,0,2,3,0,3,3,4,3,0
1255,59,42,30,22,7,22,46,47.8,24,43,6,37,36,95,35,0
1256,2,2,1,0,1,2,3,66.7,1,3,1,2,3,5,3,0
1257,20,14,12,4,4,12,18,66.7,6,11,4,7,8,28,25,1
1258,22,16,10,5,7,6,19,31.6,13,25,1,24,4,26,3,1
1259,0,0,0,0,0,0,0,,0,0,0,0,0,0,1,0
1260,33,21,21,10,2,19,35,54.3,16,13,2,11,24,57,29,2
1261,7,4,1,3,3,3,8,37.5,5,1,0,1,1,8,4,0
1262,32,18,10,15,7,14,28,50,14,5,0,5,29,61,17,1
1263,31,16,12,17,2,15,35,42.9,20,13,6,7,16,47,14,2
1264,0,0,0,0,0,0,0,,0,0,0,0,0,0,0,0
1265,9,5,2,6,1,1,10,10,9,3,1,2,4,13,3,0
1266,42,23,22,14,6,22,46,47.8,24,18,3,15,21,63,7,0
1267,6,5,5,1,0,3,5,60,2,3,0,3,2,8,6,0
1268,5,3,4,1,0,2,5,40,3,2,0,2,0,5,9,0
1269,5,3,1,1,3,1,10,10,9,20,4,16,6,11,35,0
1270,0,0,0,0,0,0,0,,0,1,0,1,0,0,1,0
1271,15,9,7,5,3,7,25,28,18,3,0,3,3,18,7,0
1272,2,1,1,1,0,1,4,25,3,1,1,0,0,2,4,0
1273,5,2,1,3,1,2,8,25,6,7,2,5,2,7,8,0
1274,12,8,4,6,2,6,24,25,18,7,0,7,3,15,3,0
1275,11,8,5,6,0,7,11,63.6,4,3,3,0,7,18,41,1
1276,30,18,21,8,1,17,26,65.4,9,42,27,15,44,74,150,0
1277,40,24,25,13,2,24,41,58.5,17,31,15,16,34,74,91,1
1278,40,24,16,17,7,27,44,61.4,17,23,3,20,21,61,44,0
1279,1,0,0,1,0,1,1,100,0,0,0,0,0,1,0,0
1280,17,11,5,9,3,6,18,33.3,12,9,0,9,2,19,1,0
1281,11,6,4,6,1,4,11,36.4,7,4,0,4,2,13,0,1
1282,28,20,10,11,7,13,35,37.1,22,21,1,20,6,34,1,0
1283,3,2,1,1,1,3,9,33.3,6,7,2,5,2,5,10,1
1284,20,18,7,12,1,9,14,64.3,5,24,6,18,15,35,47,0
1285,14,7,8,6,0,8,15,53.3,7,17,11,6,14,28,29,1
1286,42,29,22,17,3,12,21,57.1,9,24,14,10,42,84,65,0
1287,18,13,8,9,1,13,20,65,7,10,1,9,7,25,14,1
1288,0,0,0,0,0,0,2,0,2,3,1,2,0,0,1,0
1289,21,15,10,8,3,11,18,61.1,7,10,2,8,10,31,33,1
1290,5,3,2,3,0,3,6,50,3,3,0,3,0,5,1,0
1291,5,5,5,0,0,3,6,50,3,17,10,7,11,16,21,0
1292,19,9,6,11,2,7,17,41.2,10,24,5,19,24,43,26,1
1293,0,0,0,0,0,0,0,,0,0,0,0,0,0,1,0
1294,0,0,0,0,0,0,0,,0,0,0,0,1,1,0,0
1295,3,2,0,1,2,1,3,33.3,2,1,0,1,0,3,0,0
1296,12,6,2,4,6,3,15,20,12,14,1,13,2,14,8,0
1297,14,10,5,4,5,7,12,58.3,5,9,0,9,8,22,5,0
1298,54,30,36,11,7,26,41,63.4,15,27,2,25,27,81,61,1
1299,48,33,27,18,3,22,33,66.7,11,38,15,23,35,83,46,1
1300,2,1,2,0,0,1,3,33.3,2,0,0,0,1,3,2,0
1301,36,22,7,27,2,22,42,52.4,20,23,2,21,14,50,13,1
1302,7,4,5,1,1,5,6,83.3,1,4,2,2,5,12,2,0
1303,0,0,0,0,0,0,0,,0,0,0,0,0,0,2,0
1304,49,23,21,20,8,24,50,48,26,35,11,24,17,66,24,2
1305,25,16,7,10,8,11,23,47.8,12,20,0,20,4,29,6,0
1306,0,0,0,0,0,0,0,,0,2,2,0,3,3,5,0
1307,17,10,4,12,1,4,19,21.1,15,22,7,15,15,32,7,0
1308,3,2,1,2,0,0,3,0,3,2,0,2,1,4,1,0
1309,11,10,1,3,7,5,12,41.7,7,21,5,16,2,13,14,0
1310,5,4,2,1,2,2,3,66.7,1,12,3,9,2,7,12,0
1311,32,18,6,20,6,12,45,26.7,33,20,2,18,7,39,2,0
1312,11,6,3,8,0,3,6,50,3,2,0,2,4,15,1,0
1313,6,4,1,3,2,0,3,0,3,5,0,5,2,8,6,0
1314,5,2,3,2,0,1,4,25,3,4,0,4,0,5,2,0
1315,46,27,15,25,6,24,41,58.5,17,31,8,23,23,69,36,0
1316,1,0,0,1,0,0,0,,0,2,0,2,0,1,0,0
1317,21,13,11,7,3,13,22,59.1,9,0,0,0,7,28,15,1
1318,12,6,7,4,1,8,10,80,2,6,3,3,3,15,6,0
1319,0,0,0,0,0,0,0,,0,1,0,1,0,0,0,0
1320,18,11,6,10,2,3,14,21.4,11,11,3,8,4,22,3,0
1321,22,16,4,12,6,6,17,35.3,11,10,2,8,5,27,1,0
1322,8,6,2,5,1,3,6,50,3,2,0,2,4,12,2,0
1323,3,1,2,1,0,2,2,100,0,7,4,3,3,6,39,1
1324,12,5,7,5,0,7,13,53.8,6,12,0,12,1,13,8,0
1325,3,2,2,0,1,0,1,0,1,1,0,1,4,7,8,0
1326,35,20,19,12,4,19,40,47.5,21,15,6,9,27,62,60,1
1327,5,3,3,2,0,1,5,20,4,4,3,1,4,9,21,1
1328,5,4,2,3,0,1,4,25,3,1,0,1,2,7,3,0
1329,8,5,2,5,1,2,2,100,0,3,0,3,9,17,4,0
1330,18,11,13,4,1,8,12,66.7,4,18,11,7,19,37,60,1
1331,38,23,23,14,1,16,21,76.2,5,40,31,9,43,81,116,0
1332,1,1,0,1,0,0,1,0,1,0,0,0,0,1,0,0
1333,38,28,20,15,3,19,34,55.9,15,26,6,20,36,74,52,0
1334,11,5,4,4,3,6,14,42.9,8,6,2,4,8,19,8,1
1335,37,21,12,19,6,11,39,28.2,28,16,2,14,28,65,6,0
1336,19,10,9,7,3,3,17,17.6,14,14,1,13,8,27,12,0
1337,50,26,16,27,7,21,39,53.8,18,27,8,19,34,84,28,0
1338,0,0,0,0,0,0,0,,0,0,0,0,0,0,0,0
1339,5,3,0,3,2,1,4,25,3,3,0,3,1,6,10,0
1340,22,16,14,7,1,12,21,57.1,9,16,8,8,10,32,48,0
1341,29,15,22,6,1,13,22,59.1,9,57,35,22,17,46,140,0
1342,65,38,18,39,8,34,62,54.8,28,23,2,21,36,101,29,0
1343,17,8,9,6,2,9,13,69.2,4,12,7,5,13,30,9,1
1344,1,0,1,0,0,1,1,100,0,0,0,0,0,1,0,0
1345,22,17,15,7,0,6,24,25,18,26,18,8,24,46,71,1
1346,11,5,6,5,0,4,7,57.1,3,10,8,2,8,19,22,1
1347,12,8,3,4,5,7,13,53.8,6,4,0,4,0,12,1,0
1348,10,6,3,7,0,5,9,55.6,4,1,1,0,4,14,10,0
1349,16,13,7,3,6,6,9,66.7,3,3,0,3,6,22,4,0
1350,27,19,16,9,2,12,28,42.9,16,17,1,16,13,40,22,0
1351,41,28,27,10,4,22,42,52.4,20,30,14,16,26,67,114,0
1352,0,0,0,0,0,0,1,0,1,0,0,0,0,0,5,2
1353,44,26,28,13,3,22,40,55,18,37,17,20,41,85,126,1
1354,44,25,13,26,5,21,49,42.9,28,32,7,25,29,73,19,0
1355,45,31,19,20,6,24,50,48,26,23,8,15,14,59,15,0
1356,42,30,22,15,5,20,27,74.1,7,17,2,15,35,77,25,1
1357,0,0,0,0,0,0,1,0,1,1,0,1,0,0,0,0
1358,13,9,3,3,7,1,7,14.3,6,16,1,15,2,15,8,0
1359,0,0,0,0,0,0,1,0,1,0,0,0,1,1,1,0
1360,17,10,9,6,2,13,20,65,7,6,0,6,11,28,7,1
1361,22,12,15,7,0,12,22,54.5,10,10,4,6,16,38,40,2
1362,36,20,17,18,1,16,24,66.7,8,9,1,8,25,61,11,1
1363,8,4,2,5,1,3,8,37.5,5,7,0,7,3,11,9,0
1364,64,34,33,27,4,22,38,57.9,16,33,7,26,25,89,16,0
1365,22,15,19,3,0,12,17,70.6,5,7,2,5,9,31,21,1
1366,35,13,21,12,2,16,21,76.2,5,32,17,15,19,54,101,3
1367,33,19,10,18,5,20,38,52.6,18,30,4,26,16,49,31,1
1368,16,11,9,6,1,6,11,54.5,5,18,6,12,17,33,47,1
1369,36,23,14,18,4,19,40,47.5,21,23,2,21,11,47,20,0
1370,2,0,1,1,0,0,0,,0,0,0,0,1,3,0,0
1371,21,16,8,6,7,6,12,50,6,14,3,11,12,33,4,0
1372,34,24,23,9,2,12,29,41.4,17,25,8,17,40,74,36,0
1373,0,0,0,0,0,0,0,,0,0,0,0,0,0,2,0
1374,43,29,32,8,3,25,39,64.1,14,29,12,17,29,72,76,0
1375,24,16,11,10,3,15,19,78.9,4,17,9,8,17,41,42,2
1376,13,7,6,5,2,10,16,62.5,6,7,4,3,24,37,38,1
1377,20,15,10,8,2,5,8,62.5,3,14,2,12,8,28,20,0
1378,32,21,14,13,5,12,29,41.4,17,8,1,7,16,48,13,0
1379,9,5,1,6,2,5,7,71.4,2,11,2,9,3,12,7,0
1380,6,4,3,3,0,4,6,66.7,2,5,0,5,3,9,3,0
1381,0,0,0,0,0,0,0,,0,0,0,0,0,0,0,0
1382,29,19,9,18,2,14,29,48.3,15,27,4,23,14,43,38,0
1383,5,2,2,1,2,1,7,14.3,6,11,1,10,4,9,10,0
1384,39,28,20,14,5,20,50,40,30,32,1,31,17,56,40,0
1385,101,59,38,53,10,44,89,49.4,45,34,5,29,32,133,28,0
1386,0,0,0,0,0,0,0,,0,1,0,1,0,0,0,0
1387,1,1,0,0,1,0,0,,0,0,0,0,0,1,0,0
1388,33,22,8,25,0,16,50,32,34,20,3,17,17,50,6,0
1389,30,22,14,13,3,11,40,27.5,29,21,9,12,13,43,16,0
1390,1,1,0,1,0,0,1,0,1,2,1,1,0,1,1,0
1391,32,22,20,8,4,16,23,69.6,7,19,7,12,22,54,31,0
1392,35,20,15,11,9,11,26,42.3,15,14,1,13,2,37,3,0
1393,29,10,19,3,7,12,34,35.3,22,14,0,14,8,37,6,0
1394,30,15,17,8,5,11,21,52.4,10,14,5,9,6,36,10,0
1395,4,4,2,2,0,2,3,66.7,1,2,1,1,4,8,6,0
1396,12,6,3,8,1,6,14,42.9,8,6,1,5,4,16,7,0
1397,0,0,0,0,0,0,0,,0,0,0,0,0,0,0,0
1398,3,2,1,1,1,3,3,100,0,1,1,0,2,5,4,0
1399,32,17,10,6,16,12,28,42.9,16,14,0,14,4,36,6,1
1400,11,3,1,7,3,2,6,33.3,4,10,2,8,3,14,12,0
1401,6,4,2,4,0,3,6,50,3,4,0,4,2,8,6,0
1402,11,5,3,5,3,8,17,47.1,9,10,1,9,3,14,3,0
1403,21,8,7,9,5,10,14,71.4,4,7,1,6,11,32,12,1
1404,29,17,13,15,1,15,30,50,15,17,5,12,8,37,24,0
1405,20,12,8,9,3,7,17,41.2,10,15,1,14,6,26,4,0
1406,4,2,4,0,0,0,0,,0,4,0,4,0,4,0,0
1407,30,15,9,14,7,12,24,50,12,19,2,17,8,38,11,0
1408,1,1,1,0,0,0,1,0,1,1,0,1,0,1,1,0
1409,36,20,7,14,15,9,25,36,16,21,1,20,13,49,4,0
1410,6,3,2,3,1,4,9,44.4,5,5,0,5,2,8,3,0
1411,21,13,14,7,0,8,16,50,8,19,8,11,24,45,79,0
1412,0,0,0,0,0,0,1,0,1,0,0,0,0,0,17,2
1413,9,3,3,6,0,3,10,30,7,15,3,12,5,14,3,0
1414,37,18,14,18,5,20,35,57.1,15,20,1,19,13,50,6,0
1415,6,3,1,4,1,3,9,33.3,6,1,0,1,6,12,16,1
1416,21,10,16,5,0,15,25,60,10,7,4,3,14,35,20,0
1417,9,4,6,2,1,0,7,0,7,6,0,6,2,11,1,0
1418,10,8,7,3,0,6,9,66.7,3,5,3,2,12,22,40,0
1419,29,17,7,8,14,6,19,31.6,13,16,1,15,4,33,1,0
1420,3,3,0,2,1,0,12,0,12,1,1,0,0,3,1,0
1421,11,5,1,7,3,6,14,42.9,8,8,2,6,3,14,7,0
1422,20,10,5,9,6,7,11,63.6,4,4,1,3,3,23,8,0
1423,11,6,6,4,1,5,7,71.4,2,7,3,4,7,18,2,0
1424,0,0,0,0,0,0,2,0,2,1,0,1,1,1,0,0
1425,3,2,2,1,0,1,2,50,1,9,3,6,2,5,17,1
1426,21,15,17,3,1,16,22,72.7,6,29,25,4,18,39,108,2
1427,6,2,2,2,2,1,4,25,3,3,1,2,0,6,5,0
1428,7,6,6,1,0,5,5,100,0,2,0,2,3,10,4,0
1429,14,9,9,4,1,7,9,77.8,2,10,1,9,18,32,25,0
1430,8,5,1,7,0,2,9,22.2,7,9,0,9,4,12,3,0
1431,10,4,7,2,1,5,13,38.5,8,17,1,16,5,15,13,0
1432,1,0,1,0,0,1,1,100,0,3,2,1,0,1,16,0
1433,3,2,1,0,2,1,1,100,0,2,1,1,1,4,4,0
1434,18,7,7,9,2,6,10,60,4,9,1,8,4,22,12,0
1435,12,9,6,5,1,4,8,50,4,12,0,12,1,13,9,0
1436,16,10,2,7,7,6,13,46.2,7,17,0,17,10,26,7,0
1437,8,7,3,4,1,3,7,42.9,4,5,1,4,4,12,1,0
1438,40,23,21,16,3,12,25,48,13,29,7,22,23,63,13,0
1439,2,1,1,0,1,1,4,25,3,7,0,7,2,4,1,0
1440,10,5,6,0,4,6,10,60,4,14,3,11,2,12,21,0
1441,0,0,0,0,0,0,0,,0,0,0,0,0,0,0,0
1442,21,12,8,10,3,10,24,41.7,14,11,3,8,12,33,19,0
1443,27,17,10,13,4,18,33,54.5,15,17,6,11,13,40,28,1
1444,28,17,16,10,2,15,32,46.9,17,18,1,17,16,44,19,0
1445,6,4,5,0,1,4,6,66.7,2,3,0,3,2,8,4,0
1446,12,7,5,6,1,2,21,9.5,19,22,2,20,9,21,27,0
1447,92,55,45,35,12,35,95,36.8,60,43,5,38,28,120,34,1
1448,58,25,42,13,3,35,49,71.4,14,21,5,16,33,91,87,1
1449,36,23,22,12,2,17,26,65.4,9,20,12,8,29,65,61,0
1450,30,18,22,6,2,12,18,66.7,6,18,12,6,23,53,69,0
1451,4,3,1,2,1,3,8,37.5,5,5,2,3,12,16,8,0
1452,0,0,0,0,0,0,0,,0,0,0,0,0,0,0,0
1453,0,0,0,0,0,0,0,,0,0,0,0,0,0,3,2
1454,0,0,0,0,0,0,1,0,1,0,0,0,0,0,2,0
1455,2,1,2,0,0,2,3,66.7,1,1,0,1,2,4,14,1
1456,68,40,38,27,3,37,82,45.1,45,39,10,29,45,113,35,1
1457,27,15,16,11,0,16,28,57.1,12,19,12,7,23,50,77,0
1458,9,7,6,3,0,4,5,80,1,7,4,3,18,27,26,1
1459,22,13,16,5,1,13,18,72.2,5,22,14,8,13,35,105,0
1460,23,16,19,4,0,11,17,64.7,6,14,2,12,13,36,31,1
1461,22,14,8,8,6,6,18,33.3,12,9,3,6,5,27,9,0
1462,3,3,2,0,1,0,2,0,2,4,0,4,1,4,2,0
1463,0,0,0,0,0,0,0,,0,0,0,0,0,0,0,0
1464,23,16,15,7,1,11,20,55,9,15,4,11,11,34,15,0
1465,32,21,11,14,7,12,18,66.7,6,13,5,8,11,43,20,0
1466,6,4,3,1,2,3,5,60,2,2,0,2,1,7,4,0
1467,31,20,16,11,4,15,29,51.7,14,23,8,15,14,45,40,2
1468,0,0,0,0,0,0,2,0,2,0,0,0,0,0,12,0
1469,19,15,9,6,4,11,23,47.8,12,12,1,11,11,30,22,0
1470,4,3,0,3,1,2,5,40,3,4,0,4,0,4,3,0
1471,52,29,22,23,7,30,75,40,45,27,5,22,23,75,14,1
1472,53,41,26,19,8,21,49,42.9,28,32,4,28,24,77,24,0
1473,39,23,18,17,4,16,32,50,16,27,13,14,34,73,81,1
1474,0,0,0,0,0,0,2,0,2,0,0,0,1,1,11,2
1475,43,31,18,23,2,28,45,62.2,17,20,2,18,9,52,5,0
1476,2,2,1,1,0,0,0,,0,1,0,1,2,4,0,0
1477,12,7,0,4,8,7,13,53.8,6,14,0,14,1,13,13,0
1478,4,3,2,2,0,3,4,75,1,2,0,2,1,5,0,0
1479,0,0,0,0,0,0,0,,0,0,0,0,0,0,0,0
1480,13,8,7,5,1,5,9,55.6,4,4,1,3,3,16,8,0
1481,1,0,0,1,0,0,0,,0,5,1,4,0,1,2,0
1482,43,27,19,17,7,32,53,60.4,21,26,4,22,13,56,23,0
1483,24,14,17,7,0,9,17,52.9,8,23,12,11,28,52,81,0
1484,22,16,11,10,1,10,16,62.5,6,26,17,9,19,41,69,0
1485,8,6,4,3,1,5,6,83.3,1,7,4,3,10,18,29,0
1486,23,10,13,6,4,6,20,30,14,21,2,19,7,30,9,0
1487,31,16,7,21,3,13,24,54.2,11,25,8,17,16,47,25,0
1488,4,4,2,2,0,1,7,14.3,6,11,0,11,5,9,4,0
1489,12,6,8,3,1,7,12,58.3,5,2,1,1,6,18,12,0
1490,0,0,0,0,0,0,0,,0,1,0,1,0,0,3,0
1491,0,0,0,0,0,0,0,,0,0,0,0,3,3,2,0
1492,17,10,5,9,3,9,26,34.6,17,16,0,16,7,24,5,0
1493,0,0,0,0,0,0,0,,0,0,0,0,0,0,1,0
1494,13,10,8,5,0,4,8,50,4,6,2,4,15,28,24,2
1495,2,1,1,1,0,1,4,25,3,0,0,0,3,5,8,0
1496,31,14,16,10,5,17,29,58.6,12,23,2,21,15,46,19,0
1497,1,1,1,0,0,1,2,50,1,0,0,0,1,2,13,4
1498,23,19,3,14,6,8,13,61.5,5,6,0,6,5,28,3,0
1499,68,35,31,27,10,36,57,63.2,21,26,6,20,15,83,12,0
1500,47,25,20,21,6,24,39,61.5,15,39,18,21,24,71,48,0
1501,35,14,24,8,3,19,27,70.4,8,25,7,18,17,52,59,0
1502,31,16,21,4,6,15,27,55.6,12,17,4,13,20,51,21,0
1503,4,3,2,1,1,2,3,66.7,1,4,0,4,2,6,11,0
1504,36,26,25,8,3,23,42,54.8,19,20,5,15,26,62,54,0
1505,23,13,8,12,3,10,19,52.6,9,13,2,11,11,34,21,0
1506,36,21,12,18,6,18,50,36,32,33,7,26,16,52,22,0
1507,11,3,2,6,3,3,14,21.4,11,18,0,18,4,15,0,0
1508,1,0,1,0,0,1,2,50,1,0,0,0,2,3,8,0
1509,20,10,5,12,3,6,27,22.2,21,11,2,9,6,26,8,0
1510,23,15,13,9,1,15,19,78.9,4,21,15,6,9,32,55,1
1511,0,0,0,0,0,0,0,,0,0,0,0,0,0,0,1
1512,37,16,23,10,4,12,48,25,36,22,6,16,19,56,18,0
1513,0,0,0,0,0,0,1,0,1,0,0,0,0,0,5,1
1514,24,15,7,14,3,10,27,37,17,10,1,9,12,36,4,1
1515,37,20,19,13,5,22,56,39.3,34,26,3,23,21,58,18,0
1516,60,41,27,27,6,28,52,53.8,24,29,9,20,28,88,57,0
1517,48,30,26,18,4,26,36,72.2,10,32,8,24,26,74,41,0
1518,9,7,7,2,0,8,14,57.1,6,8,5,3,7,16,18,2
1519,17,15,16,1,0,13,19,68.4,6,12,8,4,15,32,53,1
1520,35,15,13,16,6,23,36,63.9,13,15,1,14,18,53,16,0
1521,0,0,0,0,0,0,0,,0,0,0,0,0,0,0,0
1522,3,2,0,2,1,0,2,0,2,9,1,8,3,6,17,0
1523,24,13,10,6,8,9,16,56.3,7,29,0,29,13,37,6,0
1524,0,0,0,0,0,0,0,,0,1,0,1,0,0,1,0
1525,9,5,3,5,1,6,12,50,6,2,1,1,4,13,2,0
1526,44,30,32,11,1,22,37,59.5,15,31,21,10,26,70,85,1
1527,53,30,41,10,2,30,45,66.7,15,23,8,15,16,69,38,0
1528,6,5,1,2,3,4,16,25,12,11,1,10,2,8,2,0
1529,19,11,13,6,0,8,14,57.1,6,10,4,6,25,44,17,0
1530,56,33,25,22,9,24,47,51.1,23,31,6,25,33,89,17,1
1531,1,0,0,0,1,1,2,50,1,0,0,0,0,1,10,0
1532,27,18,17,6,4,14,21,66.7,7,33,18,15,52,79,69,0
1533,16,10,6,8,2,6,20,30,14,21,5,16,8,24,12,0
1534,4,3,1,3,0,0,0,,0,4,1,3,1,5,1,0
1535,21,14,10,10,1,9,15,60,6,17,7,10,13,34,10,0
1536,0,0,0,0,0,0,0,,0,0,0,0,0,0,0,0
1537,0,0,0,0,0,0,0,,0,0,0,0,0,0,0,0
1538,25,14,18,7,0,7,15,46.7,8,43,32,11,29,54,131,1
1539,15,10,9,6,0,8,13,61.5,5,10,8,2,13,28,28,2
1540,15,7,4,6,5,5,13,38.5,8,8,3,5,15,30,28,0
1541,16,8,5,10,1,4,9,44.4,5,4,0,4,11,27,4,1
1542,2,0,0,1,1,1,3,33.3,2,1,1,0,0,2,1,0
1543,55,31,17,31,7,27,58,46.6,31,17,2,15,21,76,6,1
1544,42,25,15,20,7,18,31,58.1,13,16,4,12,16,58,23,0
1545,3,2,0,2,1,1,7,14.3,6,2,0,2,2,5,4,0
1546,35,18,18,12,5,14,37,37.8,23,9,0,9,12,47,5,1
1547,4,4,2,2,0,2,2,100,0,9,1,8,1,5,1,0
1548,48,33,31,12,5,28,49,57.1,21,30,9,21,17,65,50,0
1549,10,4,4,4,2,7,9,77.8,2,8,1,7,5,15,10,0
1550,4,1,2,2,0,2,4,50,2,3,0,3,1,5,1,0
1551,17,7,9,5,3,8,18,44.4,10,17,4,13,8,25,8,0
1552,23,16,15,7,1,14,15,93.3,1,17,13,4,18,41,56,0
1553,38,24,16,21,1,21,53,39.6,32,17,1,16,21,59,12,0
1554,77,48,30,40,7,44,90,48.9,46,44,11,33,21,98,42,0
1555,6,4,5,0,1,4,5,80,1,16,11,5,7,13,27,0
1556,1,0,0,0,1,0,2,0,2,0,0,0,0,1,1,0
1557,15,7,2,6,7,9,24,37.5,15,18,0,18,5,20,2,0
1558,25,18,12,10,3,8,13,61.5,5,16,0,16,11,36,14,0
1559,1,0,1,0,0,1,1,100,0,0,0,0,1,2,5,1
1560,14,10,3,10,1,7,28,25,21,12,0,12,5,19,6,0
1561,0,0,0,0,0,0,0,,0,1,1,0,0,0,0,0
1562,39,21,21,15,3,25,35,71.4,10,21,4,17,15,54,37,0
1563,0,0,0,0,0,0,0,,0,0,0,0,0,0,0,0
1564,23,12,11,8,4,3,20,15,17,15,1,14,18,41,5,1
1565,16,13,7,7,2,5,9,55.6,4,8,2,6,9,25,3,0
1566,13,6,5,8,0,6,17,35.3,11,6,4,2,9,22,11,0
1567,1,0,0,1,0,0,2,0,2,3,1,2,0,1,1,0
1568,23,13,10,10,3,9,17,52.9,8,24,10,14,23,46,13,0
1569,34,24,26,7,1,9,18,50,9,12,3,9,19,53,41,0
1570,1,0,0,0,1,1,2,50,1,1,0,1,0,1,1,0
1571,12,5,3,4,5,4,11,36.4,7,6,0,6,1,13,7,0
1572,3,1,0,3,0,0,4,0,4,5,0,5,1,4,3,0
1573,15,6,3,5,7,5,13,38.5,8,15,1,14,4,19,6,0
1574,9,4,2,3,4,4,6,66.7,2,11,0,11,4,13,6,0
1575,14,8,5,6,3,6,17,35.3,11,8,1,7,5,19,2,0
1576,15,7,2,10,3,7,18,38.9,11,10,0,10,1,16,7,0
1577,38,20,22,11,5,22,32,68.8,10,20,4,16,19,57,55,0
1578,2,2,1,1,0,1,4,25,3,1,1,0,2,4,3,0
1579,0,0,0,0,0,0,0,,0,0,0,0,1,1,9,3
1580,0,0,0,0,0,0,1,0,1,0,0,0,0,0,0,0
1581,32,15,24,7,1,14,26,53.8,12,31,13,18,39,71,54,0
1582,0,0,0,0,0,0,1,0,1,0,0,0,0,0,7,2
1583,66,43,46,19,1,38,49,77.6,11,27,12,15,30,96,59,0
1584,10,7,7,2,1,1,5,20,4,7,5,2,13,23,31,0
1585,34,18,9,20,5,20,44,45.5,24,16,3,13,12,46,21,0
1586,10,4,3,2,5,1,9,11.1,8,14,2,12,0,10,2,0
1587,16,9,8,6,2,8,18,44.4,10,14,4,10,12,28,6,0
1588,19,12,6,10,3,9,25,36,16,13,1,12,22,41,14,1
1589,0,0,0,0,0,0,0,,0,0,0,0,0,0,4,3
1590,2,1,2,0,0,1,1,100,0,0,0,0,0,2,0,0
1591,5,2,1,3,1,3,10,30,7,1,0,1,2,7,0,0
1592,1,1,1,0,0,1,2,50,1,0,0,0,0,1,1,0
1593,37,24,17,17,3,13,28,46.4,15,26,2,24,15,52,21,0
1594,14,10,5,8,1,3,9,33.3,6,11,0,11,1,15,5,0
1595,4,1,1,1,2,1,2,50,1,4,1,3,0,4,0,0
1596,2,2,1,1,0,1,1,100,0,3,3,0,5,7,13,0
1597,43,23,13,12,18,5,22,22.7,17,31,3,28,21,64,27,0
1598,0,0,0,0,0,0,1,0,1,0,0,0,0,0,7,0
1599,0,0,0,0,0,0,0,,0,0,0,0,0,0,0,0
1600,45,23,23,17,5,21,51,41.2,30,13,1,12,15,60,16,0
1601,2,2,1,1,0,2,4,50,2,1,0,1,1,3,6,0
1602,21,15,10,10,1,10,13,76.9,3,20,16,4,20,41,74,3
1603,0,0,0,0,0,0,0,,0,0,0,0,0,0,1,0
1604,47,22,24,16,7,26,55,47.3,29,31,6,25,22,69,43,0
1605,14,7,11,2,1,8,14,57.1,6,3,1,2,5,19,8,0
1606,26,12,22,4,0,13,19,68.4,6,16,10,6,17,43,84,3
1607,26,16,19,6,1,15,21,71.4,6,25,13,12,19,45,94,1
1608,1,0,0,1,0,0,0,,0,0,0,0,0,1,0,0
1609,8,5,3,4,1,1,6,16.7,5,1,0,1,4,12,2,0
1610,41,22,22,18,1,18,36,50,18,27,10,17,12,53,26,0
1611,0,0,0,0,0,0,0,,0,0,0,0,0,0,0,0
1612,36,21,20,16,0,10,23,43.5,13,30,22,8,33,69,67,0
1613,28,16,15,13,0,11,23,47.8,12,8,2,6,18,46,38,0
1614,15,10,8,2,5,4,13,30.8,9,15,1,14,6,21,3,0
1615,0,0,0,0,0,0,0,,0,0,0,0,0,0,0,0
1616,27,19,13,11,3,16,21,76.2,5,35,21,14,21,48,65,2
1617,0,0,0,0,0,0,2,0,2,2,2,0,0,0,4,1
1618,48,29,20,22,6,22,48,45.8,26,20,5,15,22,70,40,0
1619,5,2,3,2,0,1,5,20,4,4,0,4,1,6,7,0
1620,5,4,1,3,1,0,8,0,8,6,0,6,0,5,6,0
1621,0,0,0,0,0,0,2,0,2,4,0,4,1,1,2,0
1622,32,22,19,9,4,16,25,64,9,14,1,13,13,45,24,0
1623,2,2,1,1,0,1,4,25,3,0,0,0,0,2,1,0
1624,4,2,2,1,1,3,5,60,2,1,0,1,0,4,2,0
1625,0,0,0,0,0,0,0,,0,0,0,0,0,0,0,0
1626,4,4,0,3,1,4,9,44.4,5,7,0,7,3,7,8,0
1627,7,6,4,3,0,5,12,41.7,7,2,1,1,5,12,3,0
1628,22,12,9,7,6,4,16,25,12,20,1,19,9,31,12,0
1629,48,31,29,13,6,24,54,44.4,30,32,6,26,17,65,41,1
1630,0,0,0,0,0,0,2,0,2,0,0,0,1,1,14,1
1631,15,7,9,6,0,5,8,62.5,3,14,9,5,18,33,48,0
1632,22,11,2,13,7,6,17,35.3,11,28,1,27,12,34,12,1
1633,54,28,33,18,3,30,43,69.8,13,51,27,24,33,87,103,0
1634,64,36,35,27,2,33,48,68.8,15,32,16,16,36,100,68,1
1635,0,0,0,0,0,0,0,,0,0,0,0,0,0,0,0
1636,15,8,6,4,5,4,13,30.8,9,4,1,3,3,18,2,0
1637,32,25,17,11,4,16,28,57.1,12,17,6,11,32,64,53,1
1638,44,23,24,18,2,24,54,44.4,30,45,17,28,37,81,40,1
1639,5,4,2,3,0,3,7,42.9,4,6,3,3,10,15,19,1
1640,0,0,0,0,0,0,0,,0,0,0,0,1,1,3,0
1641,42,27,23,19,0,23,40,57.5,17,23,11,12,18,60,61,0
1642,22,11,9,12,1,6,14,42.9,8,10,2,8,11,33,3,0
1643,2,1,1,0,1,0,1,0,1,1,0,1,2,4,0,0
1644,1,1,1,0,0,1,1,100,0,1,0,1,0,1,0,0
1645,6,5,4,1,1,3,7,42.9,4,2,1,1,5,11,4,0
1646,19,9,7,11,1,8,20,40,12,10,3,7,12,31,10,1
1647,6,1,2,3,1,1,3,33.3,2,3,1,2,3,9,16,0
1648,39,21,19,16,4,15,24,62.5,9,20,4,16,22,61,19,1
1649,13,7,11,2,0,10,19,52.6,9,7,3,4,13,26,40,3
1650,36,18,25,8,3,20,48,41.7,28,18,9,9,16,52,40,1
1651,0,0,0,0,0,0,0,,0,3,3,0,2,2,7,0
1652,3,2,1,1,1,1,2,50,1,1,1,0,2,5,3,0
1653,2,1,0,1,1,1,2,50,1,2,0,2,0,2,0,0
1654,62,40,29,26,7,32,49,65.3,17,27,9,18,39,101,40,0
1655,10,5,2,4,4,1,2,50,1,5,0,5,5,15,0,0
1656,2,1,1,1,0,1,9,11.1,8,0,0,0,2,4,5,0
1657,18,15,7,7,4,11,22,50,11,15,0,15,3,21,9,0
1658,47,26,30,14,3,27,36,75,9,35,18,17,60,107,91,0
1659,2,0,1,1,0,1,3,33.3,2,0,0,0,3,5,1,0
1660,11,8,4,6,1,4,15,26.7,11,10,2,8,2,13,9,0
1661,10,7,2,6,2,1,2,50,1,8,0,8,0,10,5,0
1662,0,0,0,0,0,0,0,,0,0,0,0,0,0,0,0
1663,0,0,0,0,0,0,0,,0,0,0,0,1,1,0,0
1664,8,5,6,2,0,4,9,44.4,5,2,0,2,11,19,36,0
1665,9,4,7,2,0,5,29,17.2,24,16,0,16,2,11,8,0
1666,17,12,3,6,8,8,14,57.1,6,5,1,4,6,23,14,0
1667,24,12,17,3,4,10,25,40,15,8,2,6,9,33,25,2
1668,3,2,2,1,0,1,3,33.3,2,2,0,2,3,6,3,0
1669,8,4,0,3,5,3,10,30,7,4,0,4,4,12,4,0
1670,6,3,4,2,0,3,4,75,1,7,5,2,3,9,40,1
1671,35,22,21,13,1,18,25,72,7,24,12,12,36,71,80,0
1672,19,13,5,10,4,6,34,17.6,28,14,0,14,6,25,15,0
1673,0,0,0,0,0,0,0,,0,0,0,0,0,0,0,0
1674,2,1,2,0,0,2,2,100,0,0,0,0,0,2,0,0
1675,1,0,0,1,0,0,0,,0,0,0,0,0,1,0,0
1676,1,1,1,0,0,1,1,100,0,0,0,0,0,1,1,0
1677,52,29,22,25,5,28,52,53.8,24,34,4,30,19,71,12,0
1678,12,7,7,3,2,6,10,60,4,20,14,6,11,23,81,1
1679,17,8,3,12,2,4,18,22.2,14,14,2,12,13,30,19,0
1680,14,5,3,9,2,5,8,62.5,3,15,4,11,11,25,15,1
1681,53,34,31,9,13,21,45,46.7,24,34,3,31,20,73,24,0
1682,32,19,16,10,6,13,21,61.9,8,14,5,9,13,45,44,0
1683,23,15,14,7,2,8,14,57.1,6,14,8,6,26,49,33,0
1684,25,15,12,13,0,9,28,32.1,19,17,7,10,19,44,52,1
1685,30,19,19,9,2,13,26,50,13,41,32,9,40,70,94,1
1686,9,4,8,0,1,4,9,44.4,5,23,19,4,6,15,49,0
1687,33,22,16,11,6,17,36,47.2,19,18,3,15,18,51,19,0
1688,21,12,7,12,2,11,21,52.4,10,16,0,16,8,29,6,0
1689,23,12,4,16,3,6,21,28.6,15,13,1,12,3,26,14,1
1690,20,12,9,9,2,10,18,55.6,8,15,2,13,16,36,19,0
1691,1,1,1,0,0,0,1,0,1,0,0,0,0,1,0,0
1692,1,0,0,0,1,0,1,0,1,0,0,0,0,1,0,0
1693,14,9,12,2,0,8,20,40,12,10,1,9,5,19,19,1
1694,43,28,29,11,3,30,41,73.2,11,16,2,14,14,57,15,0
1695,0,0,0,0,0,0,0,,0,0,0,0,0,0,0,1
1696,44,24,22,19,3,30,37,81.1,7,21,8,13,41,85,43,3
1697,46,26,13,26,7,19,54,35.2,35,23,2,21,11,57,12,1
1698,0,0,0,0,0,0,0,,0,0,0,0,1,1,0,0
1699,15,9,10,4,1,5,9,55.6,4,4,0,4,1,16,10,0
1700,4,2,3,0,1,2,2,100,0,2,0,2,4,8,4,0
1701,54,21,27,20,7,31,41,75.6,10,29,4,25,17,71,24,0
1702,0,0,0,0,0,0,0,,0,0,0,0,0,0,3,2
1703,17,9,12,5,0,11,18,61.1,7,6,2,4,13,30,12,0
1704,12,8,7,5,0,7,14,50,7,18,4,14,13,25,2,0
1705,62,34,33,25,4,34,56,60.7,22,26,7,19,33,95,33,0
1706,33,16,27,6,0,11,18,61.1,7,34,24,10,22,55,127,0
1707,4,2,3,1,0,3,4,75,1,2,0,2,0,4,6,0
1708,0,0,0,0,0,0,0,,0,0,0,0,0,0,6,1
1709,58,35,20,28,10,22,40,55,18,27,8,19,17,75,42,0
1710,22,13,14,6,2,12,25,48,13,18,4,14,18,40,21,0
1711,1,0,1,0,0,0,0,,0,0,0,0,1,2,1,0
1712,24,13,15,9,0,10,33,30.3,23,15,3,12,10,34,15,0
1713,2,1,2,0,0,2,4,50,2,0,0,0,1,3,22,1
1714,23,17,1,11,11,9,22,40.9,13,9,0,9,0,23,0,0
1715,19,15,7,8,4,5,12,41.7,7,15,3,12,6,25,21,0
1716,16,7,8,5,3,10,17,58.8,7,7,2,5,9,25,16,0
1717,0,0,0,0,0,0,1,0,1,0,0,0,0,0,1,0
1718,8,5,1,5,2,4,6,66.7,2,5,1,4,0,8,4,0
1719,0,0,0,0,0,0,1,0,1,0,0,0,0,0,0,0
1720,0,0,0,0,0,0,0,,0,1,1,0,0,0,0,0
1721,25,16,13,9,3,13,18,72.2,5,24,12,12,18,43,54,0
1722,7,5,1,4,2,2,5,40,3,8,0,8,0,7,10,0
1723,1,1,0,0,1,0,1,0,1,0,0,0,0,1,2,0
1724,42,26,17,18,7,18,50,36,32,38,9,29,22,64,35,0
1725,2,1,2,0,0,2,2,100,0,0,0,0,1,3,15,1
1726,34,23,20,12,2,19,24,79.2,5,48,26,22,29,63,83,1
1727,12,7,7,3,2,7,8,87.5,1,11,3,8,12,24,10,0
1728,41,28,19,15,7,18,37,48.6,19,12,1,11,24,65,20,1
1729,25,15,15,6,4,11,32,34.4,21,13,1,12,7,32,12,1
1730,14,10,6,5,3,7,11,63.6,4,16,2,14,10,24,6,0
1731,21,11,10,8,3,12,29,41.4,17,13,2,11,12,33,14,0
1732,0,0,0,0,0,0,0,,0,0,0,0,0,0,0,0
1733,46,25,28,18,0,19,23,82.6,4,34,25,9,32,78,107,1
1734,9,4,4,5,0,7,7,100,0,2,1,1,2,11,9,0
1735,12,6,3,6,3,6,25,24,19,14,0,14,5,17,3,0
1736,10,3,6,4,0,5,14,35.7,9,31,18,13,41,51,116,2
1737,33,17,24,8,1,21,27,77.8,6,9,3,6,10,43,25,0
1738,6,1,2,3,1,1,3,33.3,2,1,0,1,3,9,8,0
1739,8,4,1,4,3,2,10,20,8,7,0,7,1,9,3,0
1740,13,9,10,3,0,9,17,52.9,8,9,3,6,11,24,32,0
1741,18,7,11,5,2,8,18,44.4,10,16,1,15,2,20,10,0
1742,53,36,30,20,3,20,40,50,20,36,9,27,31,84,62,0
1743,31,20,11,12,8,13,25,52,12,19,0,19,9,40,8,0
1744,14,7,8,4,2,5,10,50,5,20,5,15,3,17,19,1
1745,5,3,4,1,0,2,5,40,3,7,7,0,11,16,65,2
1746,32,15,24,6,2,13,26,50,13,10,1,9,20,52,24,0
1747,33,22,10,19,4,12,32,37.5,20,25,4,21,17,50,16,0
1748,4,4,2,0,2,2,5,40,3,6,0,6,2,6,21,0
1749,15,6,6,5,4,9,22,40.9,13,13,5,8,9,24,6,0
1750,1,0,0,1,0,0,7,0,7,2,0,2,0,1,1,0
1751,8,5,1,4,3,3,5,60,2,11,3,8,3,11,10,0
1752,14,9,5,4,5,7,14,50,7,16,1,15,5,19,29,0
1753,7,4,3,4,0,2,7,28.6,5,13,5,8,8,15,19,0
1754,12,9,8,3,1,5,9,55.6,4,8,3,5,4,16,13,1
1755,6,3,5,1,0,2,3,66.7,1,3,2,1,4,10,5,0
1756,3,1,2,1,0,1,1,100,0,1,1,0,1,4,2,0
1757,45,29,24,15,6,23,53,43.4,30,23,4,19,8,53,44,1
1758,6,5,2,4,0,4,5,80,1,4,2,2,1,7,2,0
1759,8,4,2,1,5,3,13,23.1,10,8,0,8,5,13,7,0
1760,4,1,0,4,0,2,7,28.6,5,7,1,6,1,5,1,0
1761,39,27,19,11,9,22,50,44,28,26,4,22,11,50,24,2
1762,41,22,15,20,6,15,32,46.9,17,22,10,12,16,57,16,1
1763,9,5,6,3,0,5,9,55.6,4,14,9,5,8,17,55,0
1764,1,0,0,0,1,0,1,0,1,2,1,1,0,1,1,0
1765,13,6,6,7,0,8,15,53.3,7,13,5,8,12,25,16,0
1766,1,0,1,0,0,0,2,0,2,1,0,1,0,1,24,2
1767,7,5,5,2,0,6,6,100,0,2,0,2,2,9,5,0
1768,13,11,2,8,3,5,16,31.3,11,10,5,5,1,14,20,0
1769,0,0,0,0,0,0,0,,0,1,0,1,0,0,0,0
1770,13,8,4,6,3,2,6,33.3,4,8,3,5,0,13,19,0
1771,1,0,1,0,0,0,1,0,1,0,0,0,1,2,0,0
1772,11,3,2,7,2,5,16,31.3,11,10,1,9,15,26,21,0
1773,16,10,12,2,2,11,25,44,14,13,3,10,4,20,21,2
1774,29,22,19,10,0,18,36,50,18,17,4,13,17,46,39,0
1775,4,4,2,2,0,3,6,50,3,5,2,3,1,5,16,0
1776,8,5,0,5,3,2,3,66.7,1,6,2,4,4,12,10,0
1777,2,2,2,0,0,2,3,66.7,1,1,1,0,0,2,0,0
1778,19,13,11,7,1,9,23,39.1,14,16,2,14,11,30,16,0
1779,27,14,10,14,3,12,18,66.7,6,10,1,9,3,30,11,0
1780,3,2,2,1,0,3,3,100,0,3,2,1,1,4,2,0
1781,5,1,2,3,0,3,5,60,2,1,0,1,0,5,1,0
1782,24,15,8,12,4,12,29,41.4,17,12,1,11,5,29,12,0
1783,2,2,0,1,1,0,0,,0,0,0,0,0,2,1,0
1784,4,2,3,1,0,4,5,80,1,1,0,1,1,5,5,0
1785,5,4,0,2,3,1,4,25,3,5,1,4,2,7,15,0
1786,1,0,1,0,0,0,1,0,1,5,1,4,0,1,4,0
1787,13,7,3,6,4,3,6,50,3,7,0,7,1,14,1,0
1788,9,4,0,5,4,3,11,27.3,8,10,3,7,3,12,13,0
1789,32,18,6,16,10,14,27,51.9,13,24,6,18,8,40,9,0
1790,7,5,1,2,4,1,2,50,1,0,0,0,2,9,1,0
1791,3,1,1,1,1,1,2,50,1,5,3,2,2,5,8,0
1792,51,30,24,21,6,19,44,43.2,25,21,6,15,18,69,20,0
1793,7,1,5,1,1,3,4,75,1,1,1,0,0,7,0,0
1794,48,28,19,21,8,16,54,29.6,38,18,2,16,22,70,11,0
1795,0,0,0,0,0,0,0,,0,0,0,0,0,0,0,0
1796,8,7,1,3,4,3,8,37.5,5,5,1,4,0,8,2,0
1797,31,23,16,6,9,19,29,65.5,10,22,9,13,14,45,16,0
1798,0,0,0,0,0,0,0,,0,0,0,0,0,0,0,0
1799,0,0,0,0,0,0,0,,0,0,0,0,0,0,7,4
1800,14,8,3,7,4,4,9,44.4,5,10,2,8,3,17,8,0
1801,3,2,2,1,0,0,0,,0,4,2,2,3,6,9,1
1802,46,21,10,25,11,17,39,43.6,22,25,6,19,19,65,33,1
1803,16,13,5,8,3,6,13,46.2,7,7,1,6,3,19,2,0
1804,25,13,13,10,2,14,32,43.8,18,16,3,13,4,29,24,0
1805,1,0,0,0,1,1,1,100,0,0,0,0,0,1,0,0
1806,0,0,0,0,0,0,1,0,1,0,0,0,0,0,0,0
1807,0,0,0,0,0,0,1,0,1,0,0,0,0,0,0,0
1808,6,3,1,2,3,3,9,33.3,6,8,0,8,2,8,2,0
1809,19,10,14,5,0,15,20,75,5,19,12,7,7,26,30,0
1810,9,6,3,6,0,2,8,25,6,13,5,8,7,16,47,0
1811,12,6,3,6,3,6,14,42.9,8,13,0,13,4,16,3,0
1812,18,11,11,6,1,4,9,44.4,5,13,4,9,6,24,18,0
1813,37,26,13,20,4,13,21,61.9,8,17,1,16,10,47,14,2
1814,30,20,8,15,7,11,27,40.7,16,20,1,19,15,45,3,0
1815,1,1,1,0,0,1,1,100,0,0,0,0,0,1,11,1
1816,2,2,0,2,0,0,0,,0,4,0,4,0,2,0,0
1817,0,0,0,0,0,0,0,,0,0,0,0,2,2,3,2
1818,10,5,1,6,3,3,4,75,1,3,1,2,1,11,1,0
1819,49,26,31,15,3,22,40,55,18,41,15,26,34,83,78,0
1820,23,12,9,5,9,16,29,55.2,13,20,4,16,16,39,15,0
1821,21,15,9,8,4,15,28,53.6,13,39,15,24,30,51,135,0
1822,3,2,2,1,0,1,1,100,0,2,0,2,2,5,0,0
1823,9,4,4,4,1,5,10,50,5,6,0,6,0,9,3,0
1824,20,11,13,6,1,10,19,52.6,9,17,4,13,21,41,31,0
1825,0,0,0,0,0,0,0,,0,0,0,0,0,0,0,0
1826,13,10,8,5,0,6,16,37.5,10,4,4,0,8,21,28,0
1827,9,4,6,2,1,4,8,50,4,8,0,8,3,12,11,0
1828,1,1,1,0,0,1,1,100,0,2,0,2,0,1,0,0
1829,10,8,7,1,2,3,6,50,3,10,4,6,18,28,38,1
1830,4,3,3,0,1,1,2,50,1,7,0,7,2,6,2,0
1831,14,9,5,2,7,8,18,44.4,10,10,6,4,15,29,31,1
1832,0,0,0,0,0,0,0,,0,0,0,0,1,1,6,0
1833,6,2,3,2,1,1,3,33.3,2,2,2,0,1,7,4,0
1834,12,8,7,5,0,5,8,62.5,3,8,5,3,9,21,21,0
1835,9,6,6,1,2,7,19,36.8,12,10,2,8,8,17,9,0
1836,44,32,23,18,3,11,33,33.3,22,24,11,13,30,74,38,3
1837,12,6,4,7,1,4,6,66.7,2,6,1,5,6,18,7,1
1838,4,4,1,1,2,1,1,100,0,4,1,3,0,4,6,0
1839,2,1,2,0,0,2,2,100,0,1,0,1,0,2,1,0
1840,3,0,0,1,2,3,6,50,3,2,0,2,0,3,3,0
1841,2,0,2,0,0,2,2,100,0,0,0,0,0,2,5,3
1842,10,6,4,2,4,6,13,46.2,7,2,0,2,3,13,4,0
1843,16,7,12,2,2,12,19,63.2,7,3,1,2,3,19,21,0
1844,0,0,0,0,0,0,0,,0,0,0,0,0,0,4,1
1845,13,6,6,3,4,5,13,38.5,8,18,3,15,7,20,4,0
1846,66,36,27,26,13,25,61,41,36,46,20,26,41,107,73,1
1847,22,14,6,9,7,9,19,47.4,10,7,1,6,4,26,1,1
1848,10,6,5,2,3,3,5,60,2,6,1,5,0,10,1,0
1849,5,2,1,2,2,1,6,16.7,5,4,0,4,2,7,2,0
1850,3,2,3,0,0,3,8,37.5,5,6,3,3,4,7,32,0
1851,2,0,0,2,0,0,4,0,4,3,0,3,1,3,3,0
1852,11,7,1,6,4,3,10,30,7,17,1,16,1,12,17,0
1853,18,13,10,7,1,7,9,77.8,2,8,5,3,14,32,35,3
1854,43,19,31,12,0,26,38,68.4,12,44,36,8,42,85,129,0
1855,13,6,5,6,2,8,12,66.7,4,7,0,7,7,20,7,1
1856,10,5,5,4,1,4,7,57.1,3,16,2,14,1,11,9,0
1857,6,5,1,2,3,2,5,40,3,7,0,7,1,7,8,0
1858,30,19,10,14,6,15,23,65.2,8,17,2,15,12,42,16,0
1859,34,25,26,7,1,18,24,75,6,33,23,10,21,55,66,0
1860,0,0,0,0,0,0,0,,0,0,0,0,0,0,0,0
1861,46,25,26,14,6,29,47,61.7,18,23,10,13,24,70,39,0
1862,0,0,0,0,0,0,0,,0,0,0,0,0,0,0,0
1863,12,9,5,2,5,2,7,28.6,5,7,1,6,1,13,7,0
1864,3,2,0,1,2,1,5,20,4,7,3,4,7,10,8,0
1865,26,15,5,15,6,11,18,61.1,7,18,7,11,16,42,22,0
1866,5,3,0,2,3,3,3,100,0,5,1,4,3,8,4,0
1867,0,0,0,0,0,0,0,,0,0,0,0,0,0,0,0
1868,17,7,6,10,1,10,18,55.6,8,16,0,16,9,26,5,0
1869,18,10,4,10,4,9,21,42.9,12,6,1,5,14,32,9,0
1870,8,2,1,3,4,4,7,57.1,3,4,0,4,1,9,0,0
1871,10,7,5,5,0,1,6,16.7,5,9,1,8,1,11,2,0
1872,4,2,2,2,0,1,1,100,0,2,0,2,2,6,3,0
1873,0,0,0,0,0,0,1,0,1,0,0,0,1,1,6,3
1874,52,34,26,17,9,20,45,44.4,25,21,2,19,11,63,26,1
1875,10,4,2,3,5,4,15,26.7,11,9,0,9,3,13,11,0
1876,34,24,19,13,2,14,26,53.8,12,13,9,4,55,89,100,1
1877,7,4,3,4,0,4,8,50,4,6,6,0,5,12,22,0
1878,40,28,26,14,0,19,29,65.5,10,32,17,15,19,59,64,0
1879,0,0,0,0,0,0,0,,0,1,0,1,0,0,0,0
1880,25,18,11,12,2,9,10,90,1,18,10,8,10,35,58,1
1881,0,0,0,0,0,0,0,,0,0,0,0,0,0,0,0
1882,11,4,0,5,6,2,8,25,6,17,4,13,5,16,20,0
1883,44,27,20,22,2,18,46,39.1,28,30,8,22,32,76,39,2
1884,16,9,4,11,1,6,12,50,6,13,2,11,5,21,9,0
1885,25,16,11,12,2,10,16,62.5,6,9,1,8,7,32,13,0
1886,0,0,0,0,0,0,0,,0,0,0,0,0,0,7,0
1887,18,15,12,5,1,8,21,38.1,13,13,0,13,3,21,3,0
1888,12,7,3,5,4,5,16,31.3,11,8,1,7,4,16,2,0
1889,0,0,0,0,0,0,1,0,1,0,0,0,0,0,3,0
1890,20,14,10,7,3,9,22,40.9,13,9,0,9,13,33,4,0
1891,0,0,0,0,0,0,0,,0,0,0,0,0,0,0,0
1892,2,1,2,0,0,1,1,100,0,3,2,1,1,3,8,1
1893,11,4,7,4,0,5,6,83.3,1,6,3,3,12,23,46,1
1894,25,13,14,10,1,16,30,53.3,14,18,10,8,13,38,43,1
1895,0,0,0,0,0,0,0,,0,0,0,0,0,0,1,0
1896,11,7,4,5,2,3,12,25,9,20,3,17,5,16,10,0
1897,21,17,14,6,1,10,23,43.5,13,9,5,4,26,47,41,3
1898,4,4,1,2,1,1,2,50,1,2,0,2,0,4,1,0
1899,22,13,10,10,2,16,25,64,9,15,5,10,13,35,28,0
1900,6,2,1,5,0,1,3,33.3,2,4,0,4,3,9,2,0
1901,10,5,4,4,2,5,7,71.4,2,6,1,5,2,12,3,0
1902,45,26,22,20,3,19,43,44.2,24,36,1,35,19,64,12,0
1903,40,23,26,10,4,14,21,66.7,7,23,6,17,18,58,49,0
1904,33,13,19,9,5,12,18,66.7,6,9,2,7,14,47,18,0
1905,25,13,9,11,5,15,29,51.7,14,15,2,13,12,37,20,0
1906,12,8,1,8,3,6,9,66.7,3,10,0,10,6,18,3,0
1907,0,0,0,0,0,0,1,0,1,0,0,0,0,0,1,0
1908,11,6,7,4,0,9,14,64.3,5,12,6,6,7,18,19,1
1909,1,0,1,0,0,0,0,,0,0,0,0,0,1,8,1
1910,1,1,1,0,0,1,2,50,1,1,0,1,0,1,5,0
1911,8,4,2,3,3,3,9,33.3,6,3,1,2,0,8,4,0
1912,63,41,23,35,5,27,39,69.2,12,23,5,18,28,91,34,0
1913,0,0,0,0,0,0,0,,0,0,0,0,0,0,5,0
1914,13,8,2,11,0,4,7,57.1,3,5,1,4,7,20,6,0
1915,14,8,1,7,6,3,13,23.1,10,14,0,14,2,16,6,0
1916,1,0,1,0,0,0,0,,0,1,0,1,0,1,0,0
1917,1,1,0,1,0,0,1,0,1,2,1,1,0,1,1,0
1918,12,9,6,5,1,7,16,43.8,9,10,2,8,6,18,12,0
1919,8,8,1,6,1,2,9,22.2,7,7,0,7,1,9,2,0
1920,39,28,24,15,0,21,34,61.8,13,31,19,12,34,73,108,1
1921,27,16,20,6,1,15,25,60,10,26,12,14,38,65,94,0
1922,7,3,3,1,3,4,8,50,4,3,1,2,0,7,12,0
1923,14,7,4,5,5,2,15,13.3,13,14,1,13,15,29,5,0
1924,1,1,1,0,0,0,0,,0,0,0,0,0,1,0,0
1925,22,14,9,9,4,13,33,39.4,20,26,2,24,8,30,14,0
1926,0,0,0,0,0,0,0,,0,0,0,0,0,0,0,0
1927,20,15,11,5,4,9,15,60,6,12,5,7,9,29,7,0
1928,5,3,1,1,3,0,4,0,4,6,1,5,3,8,19,0
1929,18,15,7,9,2,11,15,73.3,4,13,4,9,10,28,20,0
1930,71,45,46,16,9,43,61,70.5,18,42,6,36,30,101,70,1
1931,17,10,12,3,2,11,20,55,9,11,2,9,9,26,19,1
1932,41,26,20,11,10,15,28,53.6,13,24,6,18,19,60,21,0
1933,17,8,5,10,2,7,15,46.7,8,9,0,9,14,31,8,0
1934,0,0,0,0,0,0,1,0,1,0,0,0,2,2,0,0
1935,2,1,1,1,0,0,2,0,2,1,0,1,0,2,0,0
1936,19,8,5,13,1,10,20,50,10,8,0,8,15,34,4,1
1937,0,0,0,0,0,0,0,,0,0,0,0,1,1,0,0
1938,17,10,3,9,5,5,10,50,5,15,0,15,6,23,4,0
1939,19,8,13,5,1,6,10,60,4,17,4,13,13,32,25,0
1940,1,1,1,0,0,0,0,,0,4,3,1,1,2,5,0
1941,5,4,1,2,2,1,5,20,4,5,2,3,1,6,4,0
1942,6,3,2,1,3,1,8,12.5,7,6,1,5,0,6,5,0
1943,27,16,8,15,4,15,38,39.5,23,20,2,18,24,51,16,1
1944,19,13,13,6,0,9,9,100,0,12,2,10,8,27,31,2
1945,0,0,0,0,0,0,0,,0,0,0,0,0,0,0,0
1946,0,0,0,0,0,0,1,0,1,0,0,0,0,0,0,0
1947,0,0,0,0,0,0,0,,0,0,0,0,0,0,1,0
1948,0,0,0,0,0,0,0,,0,0,0,0,0,0,4,0
1949,13,9,9,4,0,4,6,66.7,2,4,3,1,6,19,26,0
1950,6,4,0,5,1,1,4,25,3,6,1,5,0,6,2,0
1951,4,3,1,2,1,2,2,100,0,0,0,0,1,5,0,0
1952,49,29,18,27,4,24,42,57.1,18,21,2,19,29,78,24,0
1953,35,18,19,14,2,17,24,70.8,7,25,11,14,18,53,51,0
1954,1,1,1,0,0,0,0,,0,0,0,0,1,2,0,0
1955,31,23,8,14,9,16,40,40,24,31,2,29,12,43,24,0
1956,105,60,34,48,23,48,86,55.8,38,37,4,33,35,140,52,1
1957,55,36,42,11,2,32,49,65.3,17,34,17,17,23,78,93,2
1958,3,1,0,1,2,1,1,100,0,0,0,0,1,4,1,0
1959,36,24,29,6,1,16,25,64,9,43,21,22,21,57,134,0
1960,18,9,6,10,2,9,18,50,9,13,3,10,10,28,26,0
1961,4,2,4,0,0,3,4,75,1,2,0,2,0,4,4,0
1962,2,2,0,2,0,1,4,25,3,0,0,0,4,6,6,0
1963,0,0,0,0,0,0,0,,0,0,0,0,1,1,0,0
1964,47,34,15,25,7,18,47,38.3,29,32,3,29,12,59,28,0
1965,5,4,0,5,0,1,3,33.3,2,2,0,2,1,6,3,0
1966,3,2,2,0,1,3,5,60,2,4,2,2,7,10,6,0
1967,10,7,3,3,4,7,9,77.8,2,6,0,6,5,15,5,0
1968,16,10,6,9,1,8,16,50,8,4,0,4,11,27,11,0
1969,1,1,1,0,0,1,1,100,0,2,1,1,1,2,0,0
1970,52,32,24,17,11,18,49,36.7,31,35,11,24,21,73,25,1
1971,50,27,30,15,5,26,55,47.3,29,41,14,27,30,80,68,0
1972,1,0,0,1,0,0,0,,0,0,0,0,0,1,0,0
1973,1,1,1,0,0,1,2,50,1,3,1,2,1,2,4,0
1974,58,35,16,29,13,25,45,55.6,20,21,5,16,25,83,37,1
1975,0,0,0,0,0,0,0,,0,0,0,0,0,0,0,0
1976,20,9,6,12,2,5,15,33.3,10,16,2,14,14,34,9,0
1977,1,0,0,1,0,0,0,,0,0,0,0,0,1,0,0
1978,0,0,0,0,0,0,0,,0,0,0,0,0,0,0,0
1979,13,8,8,3,2,7,10,70,3,17,12,5,10,23,36,1
1980,1,1,1,0,0,1,1,100,0,0,0,0,2,3,5,2
1981,39,17,25,11,3,23,36,63.9,13,19,3,16,11,50,35,0
1982,0,0,0,0,0,0,0,,0,1,0,1,0,0,2,0
1983,9,5,7,2,0,7,11,63.6,4,15,10,5,15,24,48,2
1984,57,35,30,19,8,29,35,82.9,6,28,14,14,38,95,64,0
1985,1,0,1,0,0,1,5,20,4,0,0,0,3,4,17,1
1986,5,3,1,2,2,3,10,30,7,4,0,4,0,5,2,0
1987,7,3,3,3,1,1,3,33.3,2,4,0,4,2,9,6,0
1988,5,4,4,1,0,0,2,0,2,3,0,3,5,10,17,0
1989,36,18,26,8,2,17,24,70.8,7,23,7,16,18,54,33,1
1990,26,20,12,9,5,14,22,63.6,8,11,1,10,11,37,21,0
1991,36,20,13,16,7,12,41,29.3,29,25,0,25,11,47,7,1
1992,25,18,13,7,5,9,22,40.9,13,13,2,11,6,31,4,1
1993,14,7,3,3,8,2,15,13.3,13,17,5,12,4,18,13,0
1994,0,0,0,0,0,0,1,0,1,0,0,0,0,0,1,0
1995,3,3,3,0,0,3,4,75,1,6,2,4,1,4,3,0
1996,5,1,1,2,2,1,2,50,1,4,1,3,0,5,2,0
1997,43,25,21,19,3,17,34,50,17,22,3,19,21,64,15,0
1998,0,0,0,0,0,0,0,,0,0,0,0,0,0,0,0
1999,13,8,10,3,0,8,8,100,0,8,2,6,7,20,11,1
2000,0,0,0,0,0,0,0,,0,0,0,0,1,1,0,0
2001,0,0,0,0,0,0,0,,0,0,0,0,0,0,3,0
2002,5,5,3,1,1,2,4,50,2,2,0,2,4,9,2,0
2003,16,8,3,12,1,13,23,56.5,10,7,4,3,8,24,16,0
2004,0,0,0,0,0,0,0,,0,0,0,0,0,0,1,0
2005,25,13,14,5,6,11,25,44,14,17,0,17,3,28,1,0
2006,1,1,1,0,0,1,1,100,0,1,0,1,0,1,1,0
2007,18,11,5,7,6,5,21,23.8,16,12,2,10,11,29,13,0
2008,2,0,2,0,0,0,0,,0,2,0,2,0,2,0,0
2009,5,4,0,2,3,2,4,50,2,2,1,1,1,6,3,0
2010,13,6,2,4,7,6,27,22.2,21,21,3,18,4,17,8,0
2011,6,5,5,1,0,1,5,20,4,2,2,0,2,8,8,1
2012,24,13,11,10,3,13,19,68.4,6,20,14,6,25,49,43,1
2013,17,7,5,11,1,9,26,34.6,17,8,1,7,14,31,11,0
2014,8,5,6,2,0,5,14,35.7,9,5,1,4,4,12,16,0
2015,32,19,17,12,3,15,33,45.5,18,16,4,12,14,46,21,0
2016,11,8,5,4,2,8,19,42.1,11,6,0,6,2,13,3,0
2017,17,8,5,8,4,4,13,30.8,9,10,0,10,4,21,2,0
2018,24,15,8,10,6,11,42,26.2,31,23,3,20,5,29,7,0
2019,1,1,1,0,0,0,3,0,3,0,0,0,0,1,1,0
2020,46,20,22,21,3,13,44,29.5,31,20,5,15,15,61,17,0
2021,3,2,2,1,0,1,3,33.3,2,2,0,2,1,4,3,0
2022,37,20,21,11,5,22,31,71,9,11,3,8,15,52,22,0
2023,55,27,39,15,1,31,40,77.5,9,34,15,19,26,81,88,1
2024,0,0,0,0,0,0,0,,0,0,0,0,0,0,0,0
2025,0,0,0,0,0,0,0,,0,0,0,0,0,0,0,0
2026,0,0,0,0,0,0,0,,0,0,0,0,0,0,0,0
2027,36,19,21,8,7,22,38,57.9,16,26,5,21,18,54,37,1
2028,48,28,20,22,6,23,43,53.5,20,23,5,18,18,66,36,0
2029,16,7,5,6,5,8,28,28.6,20,15,0,15,9,25,8,0
2030,32,19,18,12,2,17,35,48.6,18,7,5,2,19,51,35,0
2031,0,0,0,0,0,0,0,,0,1,0,1,0,0,0,0
2032,42,26,18,18,6,18,45,40,27,38,9,29,28,70,21,1
2033,7,5,2,3,2,3,4,75,1,14,4,10,2,9,16,0
2034,6,4,0,3,3,2,5,40,3,10,2,8,1,7,6,0
2035,5,1,4,1,0,2,3,66.7,1,4,1,3,1,6,0,0
2036,31,21,23,8,0,19,28,67.9,9,25,12,13,39,70,97,1
2037,21,9,16,2,3,9,16,56.3,7,11,3,8,6,27,27,1
2038,1,1,1,0,0,0,1,0,1,4,0,4,1,2,5,0
2039,2,1,1,1,0,1,1,100,0,1,0,1,0,2,0,0
2040,2,1,2,0,0,0,3,0,3,3,1,2,3,5,1,0
2041,4,3,1,3,0,2,5,40,3,3,1,2,2,6,5,0
2042,2,1,0,2,0,2,2,100,0,0,0,0,2,4,1,0
2043,14,7,1,7,6,5,20,25,15,12,3,9,0,14,30,0
2044,1,0,1,0,0,0,2,0,2,2,0,2,0,1,2,0
2045,0,0,0,0,0,0,3,0,3,2,1,1,1,1,8,0
2046,44,17,20,20,4,24,43,55.8,19,30,4,26,21,65,28,1
2047,0,0,0,0,0,0,0,,0,0,0,0,3,3,15,3
2048,43,26,22,19,2,22,36,61.1,14,21,11,10,27,70,87,1
2049,11,6,7,3,1,3,7,42.9,4,2,1,1,7,18,7,0
2050,25,18,11,12,2,15,17,88.2,2,16,3,13,9,34,22,0
2051,9,6,0,5,4,3,5,60,2,17,2,15,2,11,9,0
2052,33,20,18,9,6,11,17,64.7,6,30,23,7,23,56,175,1
2053,45,28,18,15,12,15,43,34.9,28,31,3,28,13,58,27,0
2054,5,4,1,4,0,4,4,100,0,2,1,1,2,7,19,0
2055,28,24,16,12,0,16,21,76.2,5,34,25,9,24,52,59,1
2056,2,1,1,1,0,2,4,50,2,1,0,1,1,3,0,0
2057,38,23,9,15,14,11,33,33.3,22,23,1,22,28,66,21,0
2058,44,24,20,15,9,15,37,40.5,22,26,0,26,7,51,9,1
2059,35,25,20,12,3,24,38,63.2,14,21,7,14,11,46,60,0
2060,15,7,5,7,3,7,19,36.8,12,20,2,18,10,25,14,0
2061,16,8,3,10,3,7,11,63.6,4,7,2,5,7,23,8,0
2062,27,17,13,9,5,6,28,21.4,22,19,0,19,6,33,6,0
2063,0,0,0,0,0,0,0,,0,0,0,0,0,0,0,0
2064,0,0,0,0,0,0,0,,0,0,0,0,0,0,0,0
2065,18,9,9,5,4,11,24,45.8,13,6,0,6,7,25,7,0
2066,4,3,0,4,0,1,3,33.3,2,3,0,3,0,4,6,0
2067,8,6,0,6,2,0,6,0,6,6,1,5,1,9,13,0
2068,24,16,9,11,4,10,29,34.5,19,25,3,22,13,37,11,0
2069,16,14,8,7,1,5,7,71.4,2,4,3,1,16,32,31,0
2070,1,0,1,0,0,1,3,33.3,2,0,0,0,0,1,20,2
2071,5,4,2,1,2,2,3,66.7,1,3,0,3,3,8,2,0
2072,29,17,21,7,1,12,28,42.9,16,19,14,5,32,61,68,0
2073,7,3,2,5,0,1,11,9.1,10,9,1,8,4,11,12,0
2074,11,4,3,5,3,2,8,25,6,5,1,4,5,16,4,0
2075,21,14,10,9,2,14,31,45.2,17,17,1,16,15,36,13,1
2076,60,31,30,20,10,29,48,60.4,19,31,10,21,29,89,52,0
2077,0,0,0,0,0,0,0,,0,0,0,0,0,0,0,0
2078,4,3,1,2,1,0,3,0,3,3,1,2,0,4,5,0
2079,2,2,0,2,0,0,0,,0,0,0,0,1,3,1,0
2080,0,0,0,0,0,0,0,,0,2,0,2,2,2,0,0
2081,26,14,13,11,2,19,33,57.6,14,20,4,16,19,45,29,1
2082,11,8,5,5,1,6,9,66.7,3,10,2,8,5,16,5,0
2083,1,0,1,0,0,0,0,,0,5,0,5,0,1,2,0
2084,26,12,6,16,4,18,29,62.1,11,21,7,14,23,49,19,0
2085,0,0,0,0,0,0,1,0,1,1,1,0,0,0,0,0
2086,23,18,12,9,2,7,18,38.9,11,16,3,13,5,28,17,0
2087,1,0,1,0,0,0,0,,0,0,0,0,0,1,15,0
2088,13,6,7,4,2,6,18,33.3,12,6,0,6,9,22,11,0
2089,1,1,0,0,1,0,0,,0,1,0,1,1,2,0,0
2090,1,0,1,0,0,0,0,,0,0,0,0,0,1,1,0
2091,12,8,4,4,4,4,7,57.1,3,6,0,6,9,21,2,0
2092,11,6,3,6,2,3,5,60,2,6,1,5,4,15,4,0
2093,6,3,2,3,1,3,4,75,1,4,0,4,0,6,3,0
2094,1,0,0,1,0,0,1,0,1,0,0,0,1,2,2,0
2095,1,1,0,1,0,0,3,0,3,4,0,4,0,1,3,0
2096,9,7,7,0,2,5,10,50,5,5,2,3,10,19,7,0
2097,0,0,0,0,0,0,0,,0,0,0,0,0,0,0,0
2098,0,0,0,0,0,0,0,,0,0,0,0,0,0,1,0
2099,3,2,2,1,0,1,3,33.3,2,5,0,5,3,6,1,0
2100,42,23,18,17,7,20,43,46.5,23,32,7,25,21,63,32,1
2101,2,1,2,0,0,0,3,0,3,3,0,3,2,4,4,0
2102,12,4,8,4,0,4,10,40,6,9,3,6,7,19,9,1
2103,0,0,0,0,0,0,0,,0,0,0,0,0,0,1,3
2104,0,0,0,0,0,0,0,,0,0,0,0,0,0,1,1
2105,32,21,23,9,0,9,14,64.3,5,34,25,9,26,58,135,1
2106,0,0,0,0,0,0,0,,0,0,0,0,0,0,1,0
2107,0,0,0,0,0,0,1,0,1,0,0,0,0,0,13,1
2108,25,16,5,11,9,11,24,45.8,13,14,0,14,18,43,15,0
2109,0,0,0,0,0,0,0,,0,0,0,0,0,0,1,0
2110,10,7,4,1,5,7,22,31.8,15,8,0,8,9,19,4,0
2111,0,0,0,0,0,0,0,,0,0,0,0,0,0,0,0
2112,13,10,9,3,1,12,24,50,12,9,6,3,15,28,46,2
2113,5,4,1,1,3,0,3,0,3,2,1,1,1,6,7,0
2114,29,21,12,15,2,20,37,54.1,17,22,9,13,26,55,67,3
2115,1,1,1,0,0,1,1,100,0,0,0,0,0,1,15,5
2116,45,23,18,17,10,15,34,44.1,19,22,4,18,17,62,17,0
2117,58,36,21,28,9,28,53,52.8,25,44,8,36,20,78,26,0
2118,6,2,4,2,0,4,6,66.7,2,2,1,1,6,12,11,1
2119,3,1,1,2,0,3,4,75,1,5,5,0,0,3,7,0
2120,11,6,5,4,2,4,12,33.3,8,5,1,4,4,15,7,0
2121,1,1,0,0,1,1,1,100,0,0,0,0,2,3,0,0
2122,18,14,5,3,10,9,25,36,16,24,1,23,12,30,9,0
2123,3,1,3,0,0,0,3,0,3,0,0,0,0,3,1,0
2124,26,16,8,14,4,7,24,29.2,17,17,2,15,17,43,13,0
2125,19,9,7,8,4,9,20,45,11,27,4,23,6,25,12,0
2126,9,7,0,5,4,3,9,33.3,6,6,0,6,4,13,3,0
2127,0,0,0,0,0,0,0,,0,0,0,0,0,0,0,0
2128,41,32,21,15,5,20,54,37,34,30,0,30,19,60,5,0
2129,36,22,21,11,4,14,24,58.3,10,20,5,15,15,51,20,1
2130,0,0,0,0,0,0,0,,0,0,0,0,0,0,0,0
2131,26,14,15,10,1,15,22,68.2,7,27,6,21,30,56,49,0
2132,0,0,0,0,0,0,2,0,2,1,0,1,1,1,9,2
2133,28,14,14,11,3,11,24,45.8,13,41,21,20,40,68,104,2
2134,7,5,1,2,4,2,8,25,6,5,0,5,1,8,4,0
2135,35,21,19,9,7,13,21,61.9,8,15,3,12,21,56,43,0
2136,0,0,0,0,0,0,0,,0,0,0,0,0,0,0,0
2137,32,20,11,16,5,11,37,29.7,26,38,7,31,17,49,30,0
2138,3,2,2,1,0,2,3,66.7,1,2,0,2,1,4,0,0
2139,37,22,13,11,13,15,30,50,15,21,3,18,18,55,26,0
2140,0,0,0,0,0,0,0,,0,0,0,0,1,1,2,3
2141,1,0,0,1,0,0,0,,0,1,0,1,1,2,0,0
2142,8,5,1,5,2,5,9,55.6,4,4,0,4,6,14,0,0
2143,6,4,4,0,2,1,4,25,3,3,0,3,2,8,2,0
2144,0,0,0,0,0,0,0,,0,0,0,0,0,0,0,0
2145,2,1,2,0,0,1,2,50,1,4,1,3,6,8,13,0
2146,0,0,0,0,0,0,2,0,2,0,0,0,0,0,12,3
2147,5,4,2,2,1,3,3,100,0,4,1,3,2,7,3,0
2148,26,15,11,13,2,7,22,31.8,15,10,4,6,5,31,7,0
2149,0,0,0,0,0,0,0,,0,0,0,0,0,0,1,0
2150,38,24,12,18,8,21,46,45.7,25,32,10,22,14,52,33,0
2151,11,5,2,5,4,4,9,44.4,5,7,2,5,3,14,4,0
2152,0,0,0,0,0,0,0,,0,0,0,0,0,0,0,0
2153,9,5,5,3,1,6,17,35.3,11,7,0,7,2,11,1,0
2154,23,15,17,5,1,12,16,75,4,8,1,7,18,41,39,0
2155,0,0,0,0,0,0,0,,0,1,0,1,0,0,0,0
2156,22,13,10,8,4,14,17,82.4,3,16,5,11,13,35,20,1
2157,64,30,34,28,2,23,35,65.7,12,35,13,22,47,111,52,0
2158,7,5,6,1,0,4,6,66.7,2,9,1,8,8,15,28,0
2159,19,14,12,4,3,11,23,47.8,12,12,1,11,5,24,8,0
2160,37,18,15,15,7,19,40,47.5,21,24,0,24,18,55,19,0
2161,29,16,15,8,6,10,21,47.6,11,15,4,11,19,48,42,1
2162,2,1,2,0,0,0,1,0,1,1,0,1,0,2,4,0
2163,2,1,2,0,0,2,2,100,0,1,0,1,5,7,17,5
2164,43,21,14,23,6,22,44,50,22,25,4,21,23,66,13,0
2165,1,0,1,0,0,1,1,100,0,0,0,0,0,1,3,0
2166,40,23,14,20,6,19,52,36.5,33,29,2,27,7,47,5,0
2167,19,7,7,8,4,8,28,28.6,20,12,0,12,9,28,4,0
2168,1,1,0,1,0,1,2,50,1,0,0,0,1,2,0,0
2169,21,14,12,6,3,7,14,50,7,10,6,4,10,31,14,0
2170,36,21,14,13,9,18,46,39.1,28,34,6,28,32,68,33,0
2171,28,19,10,12,6,15,30,50,15,20,5,15,17,45,38,1
2172,44,25,32,10,2,31,39,79.5,8,42,11,31,37,81,60,1
2173,2,2,2,0,0,2,5,40,3,0,0,0,0,2,1,0
2174,57,36,20,32,5,18,57,31.6,39,26,8,18,21,78,19,1
2175,28,12,21,7,0,14,23,60.9,9,18,12,6,13,41,53,1
2176,0,0,0,0,0,0,0,,0,0,0,0,0,0,1,1
2177,29,19,5,21,3,10,34,29.4,24,12,1,11,11,40,10,0
2178,10,6,8,2,0,4,10,40,6,15,11,4,9,19,45,1
2179,58,36,24,24,10,23,44,52.3,21,37,13,24,28,86,31,1
2180,15,7,1,10,4,6,13,46.2,7,11,2,9,5,20,17,1
2181,11,8,4,6,1,4,10,40,6,9,0,9,10,21,2,0
2182,1,1,0,1,0,0,1,0,1,3,0,3,1,2,1,0
2183,25,21,9,12,4,12,21,57.1,9,8,1,7,15,40,10,0
2184,31,16,14,15,2,14,27,51.9,13,22,4,18,16,47,12,0
2185,67,43,34,29,4,29,61,47.5,32,38,8,30,27,94,45,1
2186,0,0,0,0,0,0,0,,0,0,0,0,0,0,0,0
2187,2,1,2,0,0,0,2,0,2,3,0,3,0,2,0,0
2188,43,25,25,13,5,23,36,63.9,13,24,11,13,28,71,46,0
2189,13,6,1,7,5,2,18,11.1,16,16,0,16,6,19,3,0
2190,20,12,17,3,0,14,28,50,14,12,5,7,9,29,34,0
2191,17,9,12,5,0,10,14,71.4,4,11,4,7,11,28,43,0
2192,30,17,19,5,6,14,28,50,14,27,7,20,29,59,56,0
2193,0,0,0,0,0,0,0,,0,0,0,0,0,0,1,0
2194,30,13,18,12,0,10,20,50,10,27,21,6,26,56,87,0
2195,1,1,0,1,0,0,0,,0,0,0,0,0,1,2,0
2196,54,26,32,21,1,21,34,61.8,13,28,12,16,29,83,75,2
2197,0,0,0,0,0,0,0,,0,0,0,0,0,0,0,0
2198,0,0,0,0,0,0,3,0,3,4,0,4,3,3,1,0
2199,1,0,0,1,0,0,0,,0,1,0,1,1,2,1,0
2200,50,28,24,20,6,17,34,50,17,33,8,25,26,76,29,0
2201,2,2,1,0,1,1,2,50,1,0,0,0,1,3,9,0
2202,0,0,0,0,0,0,0,,0,0,0,0,0,0,0,0
2203,0,0,0,0,0,0,0,,0,1,1,0,0,0,0,0
2204,69,42,23,37,9,30,58,51.7,28,43,10,33,44,113,27,1
2205,50,24,26,22,2,23,53,43.4,30,25,3,22,28,78,46,0
2206,33,19,16,13,4,14,24,58.3,10,11,4,7,17,50,24,0
2207,1,1,0,1,0,1,1,100,0,0,0,0,1,2,2,0
2208,8,5,2,6,0,2,9,22.2,7,8,2,6,6,14,3,0
2209,57,33,47,8,2,27,52,51.9,25,44,21,23,51,108,108,4
2210,0,0,0,0,0,0,0,,0,0,0,0,0,0,0,0
2211,5,2,3,1,1,4,5,80,1,3,2,1,1,6,9,0
2212,30,22,16,13,1,10,25,40,15,14,1,13,31,61,11,0
2213,1,1,0,1,0,1,1,100,0,0,0,0,0,1,0,0
2214,29,15,19,10,0,15,21,71.4,6,31,17,14,13,42,65,1
2215,27,19,19,7,1,15,20,75,5,17,12,5,14,41,59,2
2216,27,14,15,9,3,20,28,71.4,8,14,4,10,16,43,18,0
2217,12,11,8,3,1,8,14,57.1,6,18,10,8,13,25,56,0
2218,20,10,7,13,0,9,21,42.9,12,18,2,16,6,26,12,0
2219,6,0,5,1,0,3,3,100,0,4,2,2,4,10,18,0
2220,17,12,5,9,3,8,16,50,8,14,3,11,12,29,16,0
2221,31,20,16,11,4,20,40,50,20,17,4,13,15,46,24,1
2222,41,24,30,8,3,26,48,54.2,22,13,2,11,22,63,35,0
2223,1,1,1,0,0,0,1,0,1,2,1,1,3,4,0,0
2224,50,19,19,26,5,36,63,57.1,27,20,1,19,14,64,13,1
2225,5,3,3,2,0,3,3,100,0,10,7,3,6,11,34,0
2226,0,0,0,0,0,0,0,,0,1,0,1,1,1,6,2
2227,2,1,2,0,0,0,1,0,1,5,0,5,3,5,5,0
2228,9,8,5,3,1,5,7,71.4,2,4,0,4,3,12,3,0
2229,7,4,1,4,2,1,3,33.3,2,10,2,8,5,12,6,0
2230,28,17,17,10,1,15,25,60,10,15,3,12,12,40,19,0
2231,14,5,10,3,1,11,16,68.8,5,7,1,6,6,20,18,0
2232,0,0,0,0,0,0,4,0,4,0,0,0,0,0,8,0
2233,1,0,1,0,0,1,1,100,0,0,0,0,0,1,9,2
2234,31,15,19,10,2,16,21,76.2,5,28,7,21,16,47,38,1
2235,4,2,4,0,0,3,5,60,2,5,1,4,6,10,8,0
2236,17,7,5,8,4,4,13,30.8,9,15,2,13,2,19,5,0
2237,11,7,3,8,0,2,11,18.2,9,6,2,4,6,17,10,0
2238,27,14,11,10,6,10,17,58.8,7,3,0,3,10,37,9,0
2239,39,20,19,14,6,26,39,66.7,13,34,11,23,27,66,51,1
2240,0,0,0,0,0,0,1,0,1,2,0,2,0,0,3,0
2241,1,1,0,0,1,0,1,0,1,2,0,2,0,1,0,0
2242,26,17,11,13,2,16,32,50,16,10,1,9,11,37,9,0
2243,4,1,1,2,1,2,5,40,3,4,0,4,1,5,2,0
2244,6,3,3,3,0,2,8,25,6,3,0,3,4,10,2,0
2245,7,5,3,4,0,4,10,40,6,4,2,2,4,11,5,0
2246,2,2,0,2,0,1,2,50,1,3,0,3,0,2,1,1
2247,43,25,17,11,15,12,27,44.4,15,32,0,32,13,56,18,0
2248,43,22,21,17,5,21,40,52.5,19,15,1,14,24,67,8,0
2249,9,5,4,5,0,3,5,60,2,15,10,5,7,16,31,1
2250,1,0,1,0,0,0,2,0,2,2,0,2,1,2,2,0
2251,5,1,4,1,0,1,9,11.1,8,2,0,2,2,7,0,0
2252,14,9,3,3,8,7,18,38.9,11,18,0,18,5,19,3,0
2253,11,9,3,7,1,2,12,16.7,10,8,2,6,10,21,2,0
2254,34,20,23,9,2,15,18,83.3,3,13,10,3,19,53,85,4
2255,0,0,0,0,0,0,0,,0,0,0,0,0,0,0,0
2256,51,29,33,16,2,24,34,70.6,10,56,25,31,31,82,122,1
2257,6,6,1,3,2,2,8,25,6,6,1,5,2,8,4,0
2258,44,25,28,11,5,19,31,61.3,12,30,18,12,36,80,111,0
2259,7,5,2,3,2,1,3,33.3,2,0,0,0,2,9,0,0
2260,22,11,6,12,4,12,28,42.9,16,8,0,8,9,31,10,0
2261,1,0,0,1,0,0,1,0,1,0,0,0,0,1,0,0
2262,39,18,12,16,11,11,20,55,9,25,3,22,6,45,10,0
2263,1,0,1,0,0,1,1,100,0,1,0,1,0,1,9,1
2264,1,1,0,0,1,0,2,0,2,1,0,1,5,6,2,0
2265,13,10,7,4,2,8,12,66.7,4,7,3,4,7,20,9,0
2266,11,5,6,4,1,6,9,66.7,3,9,3,6,4,15,16,1
2267,45,30,12,27,6,19,50,38,31,24,0,24,12,57,12,0
2268,28,14,16,10,2,14,31,45.2,17,28,10,18,7,35,17,0
2269,8,4,1,3,4,1,5,20,4,6,2,4,3,11,6,0
2270,1,1,0,0,1,1,1,100,0,0,0,0,0,1,0,0
2271,18,10,1,13,4,7,29,24.1,22,9,0,9,3,21,7,1
2272,6,1,1,2,3,3,9,33.3,6,8,0,8,9,15,4,0
2273,21,15,4,14,3,1,17,5.9,16,8,0,8,4,25,5,0
2274,11,5,6,3,2,5,20,25,15,11,0,11,9,20,5,1
2275,15,6,10,4,1,9,10,90,1,9,6,3,10,25,26,0
2276,19,14,7,8,4,9,23,39.1,14,13,1,12,7,26,4,0
2277,34,19,22,11,1,12,18,66.7,6,26,18,8,37,71,95,0
2278,34,24,21,6,7,21,35,60,14,22,4,18,11,45,31,0
2279,1,0,1,0,0,0,0,,0,0,0,0,3,4,8,2
2280,11,7,6,3,2,6,17,35.3,11,11,1,10,6,17,5,0
2281,25,14,11,12,2,11,17,64.7,6,22,9,13,13,38,57,0
2282,31,24,8,16,7,14,26,53.8,12,11,1,10,2,33,1,2
2283,1,1,1,0,0,1,1,100,0,0,0,0,0,1,0,0
2284,2,1,1,1,0,1,1,100,0,0,0,0,0,2,0,0
2285,19,14,5,7,7,4,26,15.4,22,12,1,11,17,36,5,0
2286,9,4,4,3,2,4,8,50,4,0,0,0,0,9,2,0
2287,35,19,11,20,4,17,35,48.6,18,14,3,11,17,52,17,0
2288,10,5,3,6,1,5,9,55.6,4,6,1,5,4,14,8,0
2289,9,6,2,4,3,5,13,38.5,8,4,0,4,1,10,1,0
2290,5,4,2,2,1,1,7,14.3,6,3,0,3,2,7,0,0
2291,26,13,14,3,9,11,29,37.9,18,12,0,12,6,32,5,0
2292,6,3,4,1,1,2,5,40,3,2,0,2,1,7,0,0
2293,6,5,0,4,2,0,1,0,1,2,0,2,0,6,2,0
2294,6,3,5,1,0,1,5,20,4,11,7,4,15,21,29,2
2295,13,8,5,6,2,6,12,50,6,5,0,5,3,16,21,0
2296,40,26,15,18,7,21,61,34.4,40,25,2,23,29,69,11,1
2297,0,0,0,0,0,0,0,,0,0,0,0,0,0,0,0
2298,36,25,26,7,3,25,35,71.4,10,16,8,8,31,67,57,1
2299,29,18,23,5,1,23,29,79.3,6,15,6,9,8,37,55,0
2300,40,21,23,11,6,22,38,57.9,16,24,10,14,35,75,42,1
2301,10,5,1,3,6,2,2,100,0,3,0,3,4,14,5,0
2302,5,2,3,1,1,2,5,40,3,4,0,4,0,5,3,0
2303,7,4,4,2,1,3,6,50,3,5,0,5,2,9,1,0
2304,6,4,3,2,1,3,5,60,2,0,0,0,0,6,2,0
2305,20,8,7,12,1,6,13,46.2,7,11,2,9,4,24,11,0
2306,35,14,26,8,1,18,26,69.2,8,27,16,11,43,78,109,0
2307,4,3,2,2,0,2,3,66.7,1,1,0,1,0,4,3,0
2308,0,0,0,0,0,0,1,0,1,4,1,3,1,1,7,0
2309,20,12,12,7,1,15,23,65.2,8,12,2,10,11,31,21,0
2310,40,23,13,25,2,20,43,46.5,23,19,2,17,16,56,23,0
2311,0,0,0,0,0,0,0,,0,1,1,0,2,2,2,0
2312,14,6,10,4,0,7,8,87.5,1,11,5,6,13,27,36,0
2313,57,33,34,22,1,36,52,69.2,16,38,21,17,31,88,71,1
2314,54,37,25,24,5,22,40,55,18,35,7,28,22,76,34,0
2315,1,0,1,0,0,1,4,25,3,1,0,1,1,2,8,1
2316,0,0,0,0,0,0,0,,0,1,0,1,0,0,0,1
2317,23,14,5,12,6,10,19,52.6,9,18,3,15,7,30,10,0
2318,1,0,0,1,0,0,0,,0,0,0,0,0,1,1,0
2319,23,10,11,10,2,11,25,44,14,9,0,9,4,27,9,0
2320,57,38,26,26,5,37,66,56.1,29,29,4,25,22,79,46,0
2321,46,28,20,24,2,19,33,57.6,14,36,14,22,36,82,38,1
2322,39,18,21,14,4,10,18,55.6,8,23,14,9,23,62,80,0
2323,1,0,1,0,0,1,1,100,0,0,0,0,2,3,5,2
2324,0,0,0,0,0,0,0,,0,0,0,0,1,1,6,2
2325,5,2,3,2,0,2,2,100,0,3,1,2,1,6,1,0
2326,5,2,1,4,0,2,5,40,3,4,0,4,1,6,1,1
2327,0,0,0,0,0,0,0,,0,0,0,0,0,0,0,0
2328,16,7,9,3,4,7,17,41.2,10,6,0,6,6,22,7,0
2329,40,24,27,10,3,25,39,64.1,14,21,13,8,39,79,41,2
2330,2,1,1,1,0,0,1,0,1,3,1,2,1,3,5,0
2331,0,0,0,0,0,0,2,0,2,2,0,2,0,0,7,0
2332,2,1,2,0,0,2,2,100,0,0,0,0,3,5,21,0
2333,61,36,42,16,3,30,52,57.7,22,33,13,20,22,83,62,1
2334,0,0,0,0,0,0,0,,0,0,0,0,0,0,0,0
2335,1,0,0,0,1,1,6,16.7,5,10,1,9,2,3,4,0
2336,0,0,0,0,0,0,1,0,1,1,0,1,0,0,1,0
2337,41,29,23,18,0,17,32,53.1,15,35,17,18,32,73,123,1
2338,39,25,24,12,3,17,43,39.5,26,12,2,10,16,55,3,0
2339,10,4,3,4,3,2,8,25,6,6,2,4,1,11,2,0
2340,0,0,0,0,0,0,1,0,1,0,0,0,0,0,0,0
2341,47,20,12,28,7,18,35,51.4,17,47,12,35,25,72,21,0
2342,36,25,18,11,7,22,32,68.8,10,16,4,12,28,64,34,0
2343,16,11,9,7,0,6,12,50,6,8,1,7,6,22,17,1
2344,15,8,6,7,2,5,17,29.4,12,9,1,8,14,29,9,0
2345,41,23,24,15,2,24,30,80,6,41,11,30,26,67,42,2
2346,1,0,1,0,0,0,1,0,1,1,0,1,0,1,0,0
2347,2,1,0,1,1,1,9,11.1,8,7,2,5,5,7,10,1
2348,3,3,2,0,1,0,5,0,5,3,0,3,1,4,3,0
2349,1,0,1,0,0,0,2,0,2,1,0,1,1,2,0,0
2350,2,2,1,0,1,0,3,0,3,2,0,2,0,2,1,0
2351,6,4,3,3,0,3,9,33.3,6,7,1,6,1,7,5,1
2352,33,20,10,19,4,18,26,69.2,8,24,9,15,21,54,42,1
2353,11,5,2,5,4,3,7,42.9,4,11,1,10,3,14,3,0
2354,41,22,11,23,7,18,36,50,18,19,3,16,14,55,5,0
2355,59,41,34,22,3,34,57,59.6,23,23,7,16,17,76,50,1
2356,22,12,6,11,5,7,13,53.8,6,8,1,7,12,34,11,0
2357,4,1,4,0,0,4,4,100,0,0,0,0,0,4,8,1
2358,34,22,19,15,0,18,24,75,6,30,22,8,29,63,91,2
2359,2,1,2,0,0,2,3,66.7,1,0,0,0,1,3,7,1
2360,17,10,2,12,3,5,13,38.5,8,6,0,6,3,20,15,0
2361,13,11,8,3,2,8,14,57.1,6,14,2,12,10,23,40,0
2362,12,3,3,5,4,3,8,37.5,5,2,1,1,1,13,3,0
2363,0,0,0,0,0,0,0,,0,0,0,0,0,0,1,0
2364,5,3,3,2,0,1,3,33.3,2,3,2,1,0,5,3,0
2365,18,9,6,7,5,7,12,58.3,5,10,1,9,7,25,3,0
2366,0,0,0,0,0,0,0,,0,1,0,1,0,0,9,2
2367,30,14,13,10,7,19,31,61.3,12,12,0,12,11,41,17,0
2368,23,14,12,9,2,10,15,66.7,5,11,1,10,9,32,26,1
2369,19,13,7,9,3,10,16,62.5,6,10,1,9,8,27,1,0
2370,10,7,7,3,0,7,9,77.8,2,8,4,4,5,15,7,0
2371,0,0,0,0,0,0,0,,0,0,0,0,0,0,1,1
2372,2,2,2,0,0,2,2,100,0,1,0,1,0,2,0,0
2373,0,0,0,0,0,0,0,,0,0,0,0,0,0,1,0
2374,23,14,9,11,3,11,25,44,14,17,4,13,7,30,16,0
2375,23,16,16,5,2,12,16,75,4,19,5,14,13,36,14,0
2376,1,1,0,0,1,0,0,,0,1,0,1,0,1,0,0
2377,7,3,1,5,1,3,6,50,3,4,0,4,0,7,2,0
2378,72,40,26,39,7,24,58,41.4,34,42,10,32,46,118,42,0
2379,16,9,9,6,1,6,15,40,9,8,2,6,6,22,12,0
2380,4,1,3,1,0,1,1,100,0,0,0,0,4,8,10,0
2381,2,1,2,0,0,1,2,50,1,0,0,0,0,2,13,1
2382,17,9,11,5,1,7,22,31.8,15,20,6,14,8,25,18,1
2383,29,18,14,11,4,18,32,56.3,14,18,13,5,13,42,46,3
2384,0,0,0,0,0,0,0,,0,0,0,0,1,1,0,0
2385,5,3,2,2,1,0,3,0,3,2,0,2,1,6,11,0
2386,21,12,13,8,0,9,17,52.9,8,44,32,12,37,58,116,0
2387,42,24,22,17,3,26,56,46.4,30,27,12,15,18,60,68,1
2388,1,1,1,0,0,1,2,50,1,0,0,0,0,1,2,0
2389,8,7,6,2,0,5,10,50,5,11,4,7,6,14,38,0
2390,0,0,0,0,0,0,1,0,1,1,0,1,0,0,1,0
2391,3,3,1,1,1,2,2,100,0,0,0,0,0,3,3,0
2392,58,39,32,19,7,35,58,60.3,23,25,4,21,23,81,46,1
2393,11,7,5,4,2,4,6,66.7,2,6,0,6,5,16,14,0
2394,35,23,18,11,6,15,32,46.9,17,25,2,23,15,50,15,1
2395,18,9,14,3,1,7,10,70,3,7,2,5,7,25,10,0
2396,8,5,5,1,2,3,15,20,12,20,5,15,2,10,36,0
2397,7,5,3,3,1,1,8,12.5,7,4,0,4,4,11,3,0
2398,1,1,1,0,0,1,4,25,3,0,0,0,1,2,3,0
2399,15,9,8,7,0,7,11,63.6,4,7,6,1,7,22,28,0
2400,2,0,0,1,1,2,3,66.7,1,1,0,1,0,2,2,0
2401,17,10,6,9,2,9,16,56.3,7,8,3,5,3,20,4,0
2402,0,0,0,0,0,0,0,,0,0,0,0,0,0,1,0
2403,19,11,11,6,2,9,10,90,1,5,0,5,4,23,3,0
2404,0,0,0,0,0,0,0,,0,0,0,0,1,1,5,0
2405,1,0,1,0,0,1,1,100,0,0,0,0,0,1,8,0
2406,1,1,0,1,0,0,0,,0,4,0,4,1,2,1,0
2407,7,4,3,4,0,2,7,28.6,5,8,0,8,2,9,7,0
2408,0,0,0,0,0,0,0,,0,0,0,0,1,1,15,3
2409,31,16,9,16,6,13,25,52,12,23,2,21,6,37,14,0
2410,21,15,14,6,1,17,25,68,8,12,3,9,15,36,32,0
2411,6,2,5,1,0,4,16,25,12,5,3,2,5,11,30,0
2412,0,0,0,0,0,0,0,,0,0,0,0,0,0,0,0
2413,38,18,11,16,11,14,35,40,21,38,1,37,25,63,35,0
2414,0,0,0,0,0,0,1,0,1,1,0,1,0,0,0,0
2415,66,32,35,25,6,23,48,47.9,25,38,15,23,40,106,54,1
2416,4,3,1,1,2,2,3,66.7,1,3,0,3,3,7,1,0
2417,1,1,0,0,1,0,5,0,5,2,0,2,0,1,0,0
2418,20,13,8,10,2,3,5,60,2,16,11,5,15,35,61,1
2419,41,26,19,20,2,17,28,60.7,11,8,2,6,20,61,19,0
2420,22,16,13,7,2,11,14,78.6,3,8,3,5,4,26,4,0
2421,4,2,2,1,1,2,2,100,0,3,1,2,1,5,8,0
2422,13,8,9,4,0,7,16,43.8,9,13,9,4,11,24,36,0
2423,89,57,36,40,13,30,49,61.2,19,28,13,15,42,131,44,1
2424,37,21,11,24,2,18,36,50,18,20,4,16,27,64,21,0
2425,2,1,1,1,0,1,1,100,0,2,1,1,1,3,2,0
2426,16,11,7,6,3,5,16,31.3,11,11,0,11,8,24,3,0
2427,0,0,0,0,0,0,0,,0,0,0,0,0,0,0,0
2428,14,6,8,2,4,11,18,61.1,7,10,3,7,4,18,15,0
2429,78,53,27,46,5,37,84,44,47,43,11,32,43,121,39,0
2430,13,7,5,6,2,7,19,36.8,12,12,3,9,8,21,24,0
2431,1,0,1,0,0,1,2,50,1,0,0,0,0,1,1,0
2432,5,4,3,1,1,2,5,40,3,3,1,2,5,10,15,0
2433,25,19,10,13,2,14,32,43.8,18,25,2,23,32,57,24,0
2434,27,16,13,8,6,10,23,43.5,13,20,8,12,17,44,28,1
2435,27,13,10,16,1,6,29,20.7,23,30,9,21,14,41,22,0
2436,19,11,14,2,3,12,17,70.6,5,6,0,6,6,25,9,1
2437,0,0,0,0,0,0,0,,0,2,1,1,0,0,0,0
2438,0,0,0,0,0,0,2,0,2,4,1,3,1,1,1,0
2439,41,29,21,17,3,19,28,67.9,9,12,5,7,28,69,75,0
2440,0,0,0,0,0,0,0,,0,0,0,0,0,0,1,1
2441,2,2,1,0,1,1,2,50,1,0,0,0,0,2,0,0
2442,12,8,8,4,0,5,9,55.6,4,8,2,6,5,17,6,0
2443,2,2,2,0,0,1,1,100,0,1,1,0,1,3,2,0
2444,14,10,9,4,1,5,9,55.6,4,20,13,7,12,26,46,0
2445,12,7,4,2,6,5,11,45.5,6,12,0,12,1,13,3,0
2446,24,10,8,12,4,6,9,66.7,3,11,2,9,9,33,8,0
2447,20,10,4,14,2,10,23,43.5,13,19,3,16,11,31,17,0
2448,66,32,29,27,10,25,73,34.2,48,22,4,18,23,89,18,0
2449,38,20,24,10,4,23,39,59,16,15,4,11,11,49,52,0
2450,18,10,9,5,4,4,6,66.7,2,13,7,6,6,24,29,0
2451,11,5,3,3,5,5,24,20.8,19,11,3,8,2,13,20,0
2452,38,19,15,17,6,18,35,51.4,17,24,2,22,14,52,14,0
2453,2,2,0,1,1,2,2,100,0,0,0,0,0,2,0,0
2454,71,48,35,27,9,40,65,61.5,25,31,12,19,28,99,60,0
2455,6,3,2,1,3,3,9,33.3,6,7,0,7,1,7,4,0
2456,35,22,17,12,6,15,25,60,10,29,0,29,11,46,22,0
2457,7,5,3,3,1,3,16,18.8,13,7,1,6,2,9,1,0
2458,0,0,0,0,0,0,0,,0,1,0,1,0,0,0,0
2459,22,13,10,10,2,15,34,44.1,19,14,4,10,12,34,12,0
2460,8,4,2,5,1,3,7,42.9,4,13,2,11,4,12,17,0
2461,18,12,14,2,2,8,15,53.3,7,22,13,9,12,30,39,0
2462,11,7,6,4,1,3,5,60,2,3,2,1,7,18,8,0
2463,10,6,2,4,4,2,9,22.2,7,13,0,13,2,12,3,0
2464,6,3,1,4,1,1,5,20,4,2,0,2,4,10,2,0
2465,23,16,11,11,1,8,17,47.1,9,15,2,13,8,31,9,0
2466,38,20,16,21,1,16,24,66.7,8,17,5,12,13,51,19,1
2467,4,0,1,2,1,0,3,0,3,4,2,2,0,4,6,0
2468,11,7,3,5,3,6,11,54.5,5,7,1,6,1,12,2,0
2469,15,9,5,9,1,7,20,35,13,20,4,16,16,31,20,1
2470,1,0,0,0,1,0,0,,0,0,0,0,0,1,0,0
2471,16,10,11,5,0,8,17,47.1,9,11,2,9,21,37,20,0
2472,28,15,14,9,5,15,34,44.1,19,15,5,10,38,66,38,0
2473,1,0,1,0,0,0,1,0,1,0,0,0,0,1,5,0
2474,35,23,8,16,11,13,31,41.9,18,29,2,27,16,51,25,0
2475,16,8,3,5,8,7,13,53.8,6,6,1,5,2,18,20,1
2476,0,0,0,0,0,0,0,,0,0,0,0,0,0,0,0
2477,82,49,35,36,11,43,68,63.2,25,36,8,28,51,133,38,0
2478,20,10,16,4,0,11,17,64.7,6,23,13,10,31,51,96,0
2479,2,2,2,0,0,1,4,25,3,4,0,4,2,4,1,0
2480,7,4,4,2,1,2,4,50,2,0,0,0,2,9,2,0
2481,28,14,7,16,5,18,35,51.4,17,15,3,12,19,47,11,0
2482,39,18,32,7,0,19,28,67.9,9,35,23,12,27,66,140,3
2483,37,21,16,17,4,18,45,40,27,41,12,29,29,66,47,2
2484,3,2,3,0,0,1,5,20,4,1,0,1,2,5,6,0
2485,28,15,12,13,3,10,20,50,10,19,10,9,11,39,18,0
2486,44,26,30,11,3,26,37,70.3,11,32,16,16,30,74,89,1
2487,31,20,19,12,0,12,31,38.7,19,19,4,15,23,54,15,0
2488,12,9,7,3,2,9,16,56.3,7,4,1,3,7,19,12,0
2489,36,21,28,7,1,13,28,46.4,15,84,65,19,37,73,158,3
2490,0,0,0,0,0,0,0,,0,0,0,0,1,1,2,0
2491,2,1,2,0,0,1,3,33.3,2,2,1,1,2,4,4,0
2492,45,23,17,21,7,20,45,44.4,25,29,4,25,14,59,22,0
2493,26,17,15,10,1,7,22,31.8,15,17,1,16,8,34,21,0
2494,23,16,11,11,1,11,17,64.7,6,14,1,13,7,30,30,0
2495,44,28,16,26,2,16,26,61.5,10,14,4,10,30,74,33,0
2496,1,1,0,1,0,1,1,100,0,5,1,4,0,1,1,0
2497,0,0,0,0,0,0,0,,0,0,0,0,0,0,0,0
2498,13,8,8,5,0,8,13,61.5,5,13,5,8,15,28,23,0
2499,0,0,0,0,0,0,0,,0,0,0,0,1,1,6,3
2500,14,7,4,6,4,2,10,20,8,6,2,4,6,20,6,0
2501,13,9,7,4,2,8,12,66.7,4,4,3,1,8,21,11,0
2502,2,1,2,0,0,2,3,66.7,1,0,0,0,1,3,11,0
2503,5,4,1,2,2,5,7,71.4,2,3,1,2,2,7,2,1
2504,4,2,1,3,0,2,6,33.3,4,6,2,4,3,7,3,1
2505,25,11,7,9,9,13,24,54.2,11,15,2,13,14,39,6,0
2506,10,6,6,3,1,7,13,53.8,6,10,3,7,4,14,8,0
2507,12,6,4,6,2,5,15,33.3,10,6,0,6,2,14,2,0
2508,21,10,8,5,8,10,19,52.6,9,9,0,9,13,34,2,0
2509,63,36,35,17,11,28,36,77.8,8,33,13,20,32,95,63,1
2510,1,0,0,1,0,1,5,20,4,3,0,3,1,2,1,0
2511,26,17,15,8,3,16,26,61.5,10,21,10,11,27,53,94,2
2512,19,16,15,4,0,8,14,57.1,6,9,5,4,6,25,38,1
2513,3,1,2,1,0,1,2,50,1,4,3,1,9,12,24,1
2514,8,7,3,4,1,2,8,25,6,9,2,7,5,13,5,0
2515,14,6,7,5,2,4,8,50,4,7,0,7,2,16,3,0
2516,14,13,7,5,2,11,23,47.8,12,13,2,11,23,37,23,0
2517,19,9,8,6,5,9,30,30,21,18,0,18,3,22,2,0
2518,17,14,5,8,4,8,24,33.3,16,16,0,16,4,21,8,0
2519,19,9,7,10,2,11,18,61.1,7,9,4,5,2,21,18,0
2520,14,7,4,8,2,5,13,38.5,8,15,4,11,12,26,13,0
2521,13,6,3,5,5,6,11,54.5,5,15,3,12,6,19,20,0
2522,44,24,20,20,4,18,38,47.4,20,28,10,18,32,76,30,0
2523,1,1,1,0,0,0,0,,0,0,0,0,0,1,0,0
2524,48,28,20,20,8,21,45,46.7,24,31,6,25,19,67,16,0
2525,12,6,7,4,1,5,7,71.4,2,6,1,5,9,21,15,0
2526,9,5,1,6,2,4,12,33.3,8,11,2,9,7,16,15,0
2527,63,41,45,15,3,34,49,69.4,15,36,16,20,34,97,98,2
2528,16,8,10,4,2,10,14,71.4,4,16,8,8,9,25,29,0
2529,10,5,4,5,1,3,8,37.5,5,4,0,4,1,11,7,0
2530,3,1,1,1,1,3,8,37.5,5,4,0,4,7,10,2,0
2531,9,9,2,4,3,4,15,26.7,11,12,2,10,9,18,6,0
2532,33,21,13,17,3,17,44,38.6,27,16,2,14,17,50,12,0
2533,30,21,16,11,3,16,23,69.6,7,21,9,12,14,44,40,1
2534,40,28,22,18,0,21,41,51.2,20,28,12,16,47,87,60,1
2535,1,0,0,0,1,1,2,50,1,1,0,1,0,1,1,0
2536,8,4,2,3,3,6,9,66.7,3,8,2,6,1,9,3,0
2537,27,18,12,10,5,13,18,72.2,5,7,0,7,14,41,15,1
2538,4,2,2,1,1,1,3,33.3,2,3,2,1,5,9,19,0
2539,60,29,38,21,1,17,27,63,10,36,19,17,24,84,58,0
2540,52,34,28,19,5,23,36,63.9,13,23,8,15,22,74,17,1
2541,21,12,4,9,8,7,22,31.8,15,23,9,14,12,33,33,0
2542,1,0,0,1,0,1,2,50,1,0,0,0,1,2,1,0
2543,1,1,0,1,0,1,1,100,0,2,1,1,2,3,3,0
2544,10,4,3,5,2,4,14,28.6,10,8,1,7,2,12,5,0
2545,32,20,12,10,10,15,41,36.6,26,23,5,18,9,41,8,0
2546,29,16,17,8,4,17,25,68,8,27,22,5,9,38,108,2
2547,0,0,0,0,0,0,0,,0,0,0,0,0,0,0,0
2548,41,28,23,14,4,14,32,43.8,18,16,3,13,34,75,49,1
2549,0,0,0,0,0,0,0,,0,0,0,0,0,0,0,0
2550,5,4,2,3,0,3,5,60,2,5,2,3,5,10,2,0
2551,60,33,26,29,5,26,64,40.6,38,38,5,33,60,120,40,0
2552,2,1,1,1,0,1,2,50,1,1,0,1,0,2,5,0
2553,15,5,11,4,0,10,12,83.3,2,21,8,13,15,30,42,1
2554,61,30,28,24,9,19,42,45.2,23,28,1,27,39,100,56,1
2555,3,2,0,2,1,0,1,0,1,0,0,0,0,3,1,0
2556,12,6,5,4,3,3,7,42.9,4,7,1,6,2,14,9,0
2557,0,0,0,0,0,0,1,0,1,2,0,2,0,0,0,0
2558,10,4,4,3,3,2,6,33.3,4,4,2,2,7,17,1,0
2559,5,3,4,1,0,4,6,66.7,2,9,2,7,8,13,6,0
2560,33,21,19,12,2,18,37,48.6,19,27,6,21,30,63,52,0
2561,1,1,1,0,0,0,2,0,2,2,0,2,0,1,9,0
2562,0,0,0,0,0,0,0,,0,1,0,1,0,0,6,0
2563,36,26,8,18,10,7,26,26.9,19,23,3,20,6,42,7,1
2564,13,8,7,3,3,7,20,35,13,7,2,5,3,16,2,0
2565,28,15,15,11,2,18,27,66.7,9,13,1,12,23,51,42,0
2566,55,40,29,22,4,35,68,51.5,33,30,12,18,37,92,65,1
2567,10,3,7,3,0,6,7,85.7,1,3,2,1,3,13,4,0
2568,7,5,2,1,4,4,8,50,4,10,0,10,4,11,0,0
2569,10,6,7,1,2,1,8,12.5,7,17,0,17,6,16,1,0
2570,62,32,36,17,9,31,46,67.4,15,32,8,24,22,84,55,0
2571,8,6,3,4,1,2,4,50,2,6,1,5,7,15,4,0
2572,13,8,9,2,2,9,14,64.3,5,8,1,7,7,20,13,0
2573,0,0,0,0,0,0,0,,0,0,0,0,0,0,0,0
2574,1,1,1,0,0,0,6,0,6,5,1,4,7,8,6,0
2575,10,6,6,4,0,3,9,33.3,6,3,1,2,15,25,29,0
2576,0,0,0,0,0,0,0,,0,0,0,0,0,0,1,0
2577,3,3,3,0,0,1,5,20,4,2,0,2,0,3,3,0
2578,36,23,18,13,5,22,39,56.4,17,37,11,26,36,72,102,1
2579,61,37,36,20,5,29,51,56.9,22,28,5,23,28,89,22,0
2580,4,1,1,2,1,3,5,60,2,7,1,6,1,5,2,0
2581,30,15,11,17,2,14,21,66.7,7,19,7,12,18,48,12,0
2582,1,1,1,0,0,1,1,100,0,0,0,0,0,1,0,1
2583,1,1,0,0,1,0,0,,0,0,0,0,0,1,0,0
2584,37,23,16,21,0,15,20,75,5,17,9,8,18,55,49,0
2585,22,12,5,15,2,7,19,36.8,12,15,2,13,4,26,29,0
2586,4,3,2,1,1,1,1,100,0,1,0,1,0,4,1,0
2587,25,13,9,12,4,9,27,33.3,18,11,1,10,15,40,10,0
2588,60,34,39,21,0,26,41,63.4,15,24,6,18,25,85,66,4
2589,28,17,20,7,1,12,19,63.2,7,14,10,4,30,58,69,2
2590,4,2,2,2,0,2,3,66.7,1,2,0,2,1,5,0,0
2591,8,5,4,4,0,7,12,58.3,5,6,2,4,7,15,5,0
2592,6,4,3,3,0,2,5,40,3,4,2,2,4,10,6,0
2593,0,0,0,0,0,0,0,,0,0,0,0,0,0,0,0
2594,13,7,5,6,2,7,11,63.6,4,13,2,11,6,19,22,0
2595,8,5,4,2,2,2,9,22.2,7,10,1,9,1,9,2,0
2596,68,37,21,36,11,36,89,40.4,53,42,8,34,32,100,23,0
2597,40,19,23,14,3,22,51,43.1,29,11,2,9,13,53,35,0
2598,12,6,4,6,2,5,7,71.4,2,4,0,4,8,20,6,0
2599,0,0,0,0,0,0,0,,0,1,0,1,0,0,3,0
2600,35,25,17,16,2,10,21,47.6,11,23,8,15,25,60,59,0
2601,1,1,1,0,0,0,0,,0,4,3,1,5,6,23,0
2602,20,14,12,7,1,10,17,58.8,7,29,12,17,19,39,80,0
2603,0,0,0,0,0,0,0,,0,0,0,0,0,0,0,0
2604,4,1,1,2,1,1,6,16.7,5,2,0,2,1,5,3,0
2605,13,7,4,8,1,5,11,45.5,6,9,3,6,3,16,4,0
2606,30,19,14,11,5,13,26,50,13,26,4,22,16,46,15,0
2607,22,12,12,9,1,7,16,43.8,9,18,11,7,25,47,100,1
2608,65,38,25,29,11,36,55,65.5,19,29,6,23,38,103,26,1
2609,23,8,17,6,0,6,16,37.5,10,23,16,7,10,33,81,0
2610,8,4,4,1,3,1,6,16.7,5,12,2,10,2,10,21,0
2611,11,5,5,4,2,3,9,33.3,6,6,2,4,5,16,14,1
2612,20,13,18,2,0,11,23,47.8,12,17,12,5,23,43,60,1
2613,11,8,8,1,2,5,8,62.5,3,3,0,3,1,12,8,0
2614,5,3,1,3,1,2,2,100,0,2,1,1,0,5,7,0
2615,25,17,16,7,2,14,15,93.3,1,9,0,9,6,31,6,0
2616,38,23,10,20,8,19,33,57.6,14,26,8,18,13,51,30,0
2617,35,15,11,21,3,12,37,32.4,25,22,1,21,14,49,5,0
2618,4,3,1,1,2,3,3,100,0,7,4,3,3,7,17,1
2619,24,14,14,10,0,14,23,60.9,9,24,13,11,28,52,82,0
2620,24,7,16,7,1,12,22,54.5,10,25,5,20,5,29,11,0
2621,57,31,43,12,2,34,52,65.4,18,27,8,19,19,76,48,0
2622,38,25,21,16,1,25,34,73.5,9,34,20,14,20,58,92,2
2623,3,1,0,3,0,1,5,20,4,3,0,3,1,4,0,0
2624,14,6,6,7,1,9,13,69.2,4,3,2,1,4,18,14,2
2625,2,2,2,0,0,1,3,33.3,2,5,0,5,8,10,3,0
2626,12,7,6,3,3,4,8,50,4,7,0,7,0,12,2,0
2627,7,3,6,1,0,4,8,50,4,7,6,1,10,17,28,0
2628,46,26,13,28,5,20,40,50,20,16,5,11,30,76,33,2
2629,60,37,28,29,3,32,69,46.4,37,38,6,32,21,81,8,2
2630,14,7,6,5,3,8,17,47.1,9,9,1,8,9,23,3,0
2631,40,23,14,21,5,19,55,34.5,36,25,6,19,28,68,30,2
2632,0,0,0,0,0,0,1,0,1,0,0,0,0,0,12,2
2633,8,4,4,2,2,2,6,33.3,4,7,1,6,10,18,25,0
2634,11,5,6,3,2,4,21,19,17,21,2,19,14,25,11,0
2635,18,9,9,9,0,12,24,50,12,17,8,9,19,37,38,0
2636,26,14,16,5,5,16,30,53.3,14,16,3,13,19,45,26,1
2637,0,0,0,0,0,0,0,,0,0,0,0,0,0,0,0
2638,6,4,3,0,3,3,5,60,2,5,0,5,4,10,1,0
2639,,0,,,,,,,,,,,0,,,
2640,,10,,,,,,,,,,,13,,,
2641,4,4,2,2,0,2,4,50,2,2,0,2,3,7,0,0
2642,2,0,2,0,0,0,0,,0,0,0,0,0,2,0,0
2643,0,0,0,0,0,0,0,,0,0,0,0,0,0,0,0
2644,36,19,10,22,4,14,32,43.8,18,12,5,7,12,48,16,0
2645,6,3,2,3,1,4,9,44.4,5,0,0,0,0,6,0,0
2646,25,18,9,11,5,10,22,45.5,12,8,0,8,7,32,3,0
2647,0,0,0,0,0,0,0,,0,0,0,0,0,0,1,0
2648,13,7,4,8,1,7,15,46.7,8,11,3,8,4,17,9,1
2649,6,4,1,3,2,4,9,44.4,5,5,1,4,4,10,2,0
2650,0,0,0,0,0,0,0,,0,0,0,0,0,0,3,0
2651,2,1,2,0,0,1,2,50,1,2,0,2,0,2,3,0
2652,3,1,1,1,1,1,3,33.3,2,5,1,4,2,5,5,0
2653,2,2,1,1,0,1,2,50,1,0,0,0,0,2,1,0
2654,2,0,0,2,0,0,3,0,3,4,0,4,0,2,6,0
2655,3,2,1,1,1,0,4,0,4,0,0,0,2,5,1,0
2656,4,2,1,1,2,2,5,40,3,9,3,6,8,12,22,0
2657,3,3,0,1,2,0,3,0,3,1,0,1,0,3,5,0
2658,43,21,18,18,7,20,64,31.3,44,21,3,18,19,62,12,0
2659,33,20,22,11,0,19,26,73.1,7,19,10,9,22,55,71,1
2660,7,4,0,3,4,3,7,42.9,4,9,3,6,3,10,6,1
2661,24,16,7,12,5,9,22,40.9,13,18,1,17,5,29,8,0
2662,1,1,0,0,1,0,0,,0,1,0,1,0,1,0,0
2663,15,10,10,5,0,9,21,42.9,12,18,11,7,26,41,65,0
2664,18,10,12,5,1,10,17,58.8,7,6,1,5,8,26,23,1
2665,7,3,0,5,2,1,4,25,3,5,0,5,2,9,0,0
2666,3,2,1,1,1,0,1,0,1,2,0,2,2,5,0,0
2667,0,0,0,0,0,0,0,,0,0,0,0,1,1,0,0
2668,2,2,0,1,1,1,2,50,1,2,1,1,0,2,1,0
2669,0,0,0,0,0,0,0,,0,0,0,0,0,0,1,0
2670,22,13,14,8,0,6,11,54.5,5,10,6,4,32,54,58,0
2671,0,0,0,0,0,0,0,,0,2,0,2,0,0,2,0
2672,67,34,34,26,7,36,75,48,39,37,10,27,40,107,37,0
2673,7,2,4,2,1,6,15,40,9,4,0,4,7,14,4,0
2674,5,2,2,1,2,2,8,25,6,1,0,1,3,8,3,0
2675,10,6,5,5,0,3,17,17.6,14,8,2,6,9,19,8,0
2676,45,23,24,18,3,17,28,60.7,11,34,7,27,18,63,38,0
2677,2,1,1,1,0,0,1,0,1,3,3,0,1,3,12,0
2678,23,16,13,10,0,15,16,93.8,1,12,3,9,14,37,28,0
2679,3,1,1,2,0,1,1,100,0,0,0,0,0,3,1,0
2680,1,1,1,0,0,1,3,33.3,2,0,0,0,0,1,14,2
2681,31,21,20,6,5,16,22,72.7,6,23,12,11,20,51,59,1
2682,51,27,21,23,7,17,49,34.7,32,20,4,16,39,90,37,0
2683,15,10,3,9,3,7,21,33.3,14,18,2,16,8,23,31,0
2684,20,11,10,8,2,12,24,50,12,13,2,11,17,37,15,0
2685,18,11,9,6,3,8,13,61.5,5,26,16,10,17,35,45,4
2686,6,3,4,0,2,1,5,20,4,6,2,4,7,13,7,0
2687,29,12,14,14,1,16,29,55.2,13,14,1,13,12,41,21,0
2688,2,0,0,0,2,1,1,100,0,1,0,1,0,2,1,0
2689,59,38,29,23,7,30,57,52.6,27,42,6,36,25,84,28,1
2690,7,2,2,4,1,2,5,40,3,2,0,2,2,9,5,0
2691,2,1,1,1,0,0,4,0,4,8,0,8,1,3,7,0
2692,12,6,0,5,7,4,9,44.4,5,15,1,14,3,15,13,0
2693,0,0,0,0,0,0,0,,0,0,0,0,0,0,0,0
2694,6,3,3,2,1,3,10,30,7,10,0,10,6,12,5,0
2695,50,29,20,24,6,34,52,65.4,18,36,7,29,18,68,66,0
2696,0,0,0,0,0,0,1,0,1,0,0,0,0,0,0,0
2697,0,0,0,0,0,0,0,,0,0,0,0,0,0,1,0
2698,22,14,14,7,1,16,28,57.1,12,20,6,14,30,52,22,0
2699,32,19,22,10,0,14,26,53.8,12,35,21,14,47,79,83,4
2700,2,1,0,2,0,0,1,0,1,4,1,3,2,4,2,0
2701,16,12,4,10,2,7,12,58.3,5,9,3,6,5,21,25,0
2702,63,41,42,16,5,35,63,55.6,28,29,7,22,30,93,36,0
2703,25,12,7,12,6,13,31,41.9,18,34,1,33,6,31,10,1
2704,11,6,7,2,2,7,19,36.8,12,10,0,10,8,19,6,0
2705,43,26,11,21,11,24,49,49,25,47,8,39,20,63,16,0
2706,7,1,0,6,1,0,1,0,1,2,0,2,1,8,4,0
2707,13,8,5,6,2,5,13,38.5,8,8,0,8,3,16,6,0
2708,31,19,14,8,9,11,30,36.7,19,21,2,19,13,44,12,0
2709,6,1,1,2,3,2,5,40,3,7,3,4,1,7,8,0
2710,17,10,3,12,2,10,30,33.3,20,6,4,2,12,29,11,0
2711,2,2,1,1,0,0,2,0,2,1,1,0,0,2,7,0
2712,14,8,7,7,0,7,12,58.3,5,10,1,9,1,15,6,0
2713,3,1,3,0,0,0,1,0,1,5,2,3,1,4,20,0
2714,14,9,3,7,4,6,10,60,4,8,0,8,6,20,14,0
2715,18,10,10,7,1,10,15,66.7,5,12,7,5,15,33,48,0
2716,16,13,6,10,0,11,17,64.7,6,16,10,6,17,33,39,1
2717,10,7,4,5,1,4,10,40,6,3,0,3,2,12,7,0
2718,20,14,8,9,3,13,25,52,12,34,9,25,17,37,22,1
2719,7,3,4,2,1,2,5,40,3,7,1,6,1,8,7,0
2720,5,4,0,3,2,3,5,60,2,2,2,0,1,6,7,0
2721,0,0,0,0,0,0,1,0,1,2,1,1,1,1,2,0
2722,14,6,8,6,0,7,9,77.8,2,11,5,6,6,20,46,0
2723,0,0,0,0,0,0,1,0,1,0,0,0,0,0,1,0
2724,39,16,28,9,2,17,24,70.8,7,26,18,8,19,58,86,1
2725,10,3,6,3,1,7,16,43.8,9,11,2,9,6,16,8,0
2726,29,23,9,15,5,13,32,40.6,19,24,9,15,12,41,37,1
2727,15,9,10,5,0,6,8,75,2,18,15,3,24,39,76,0
2728,28,15,12,13,3,12,18,66.7,6,22,8,14,8,36,37,0
2729,0,0,0,0,0,0,0,,0,2,0,2,0,0,1,0
2730,3,3,1,2,0,1,4,25,3,4,0,4,1,4,2,0
2731,5,3,2,3,0,1,3,33.3,2,3,0,3,4,9,3,0
2732,4,4,2,2,0,1,6,16.7,5,1,0,1,4,8,5,0
2733,8,4,5,3,0,3,6,50,3,6,1,5,16,24,23,1
2734,31,20,18,13,0,16,27,59.3,11,37,27,10,45,76,126,1
2735,39,20,28,10,1,27,36,75,9,21,9,12,17,56,56,0
2736,57,34,29,21,7,29,46,63,17,23,6,17,52,109,49,0
2737,0,0,0,0,0,0,1,0,1,0,0,0,0,0,0,0
2738,30,19,14,12,4,7,21,33.3,14,27,3,24,19,49,10,1
2739,9,6,7,2,0,4,10,40,6,12,10,2,9,18,46,1
2740,30,18,12,11,7,8,20,40,12,20,1,19,15,45,8,0
2741,7,5,1,5,1,3,15,20,12,8,0,8,9,16,6,0
2742,9,5,5,2,2,2,6,33.3,4,3,0,3,3,12,9,0
2743,6,3,1,4,1,2,2,100,0,2,0,2,2,8,1,0
2744,12,7,5,6,1,7,19,36.8,12,12,1,11,5,17,10,0
2745,15,8,10,4,1,7,10,70,3,4,2,2,11,26,22,0
2746,33,17,18,12,3,16,54,29.6,38,23,1,22,24,57,15,0
2747,46,28,15,24,7,15,53,28.3,38,43,3,40,33,79,20,0
2748,2,1,1,0,1,2,5,40,3,0,0,0,1,3,7,0
2749,21,13,11,6,4,8,21,38.1,13,9,0,9,9,30,5,0
2750,7,5,2,4,1,2,7,28.6,5,11,0,11,2,9,0,0
2751,4,2,3,1,0,2,3,66.7,1,5,4,1,5,9,17,0
2752,1,0,0,1,0,0,0,,0,0,0,0,0,1,1,0
2753,0,0,0,0,0,0,0,,0,0,0,0,0,0,0,0
2754,2,2,0,0,2,1,2,50,1,4,1,3,2,4,12,0
2755,15,9,6,7,2,5,8,62.5,3,10,1,9,5,20,9,0
2756,11,7,4,5,2,5,15,33.3,10,5,0,5,6,17,4,0
2757,28,18,17,7,4,16,26,61.5,10,12,2,10,20,48,38,1
2758,1,1,1,0,0,0,2,0,2,3,0,3,2,3,6,0
2759,0,0,0,0,0,0,0,,0,0,0,0,0,0,0,0
2760,1,1,0,1,0,0,0,,0,0,0,0,0,1,0,0
2761,2,1,1,1,0,1,1,100,0,1,0,1,1,3,2,0
2762,2,0,1,1,0,0,7,0,7,6,2,4,11,13,5,0
2763,0,0,0,0,0,0,1,0,1,0,0,0,1,1,0,0
2764,39,24,24,14,1,23,43,53.5,20,31,9,22,16,55,32,0
2765,9,3,3,3,3,5,12,41.7,7,6,0,6,2,11,2,0
2766,0,0,0,0,0,0,4,0,4,0,0,0,0,0,13,1
2767,8,3,4,3,1,3,4,75,1,2,0,2,0,8,2,0
2768,0,0,0,0,0,0,0,,0,0,0,0,0,0,1,0
2769,3,2,2,1,0,1,1,100,0,0,0,0,0,3,1,0
2770,15,10,4,6,5,11,18,61.1,7,6,0,6,2,17,1,0
2771,13,8,1,9,3,9,17,52.9,8,11,4,7,14,27,6,0
2772,9,5,5,4,0,3,4,75,1,7,2,5,9,18,11,2
2773,36,16,14,14,8,21,36,58.3,15,18,2,16,19,55,28,2
2774,3,1,0,1,2,2,5,40,3,1,1,0,4,7,3,0
2775,18,10,11,5,2,4,9,44.4,5,6,0,6,4,22,5,1
2776,1,1,1,0,0,1,1,100,0,0,0,0,0,1,0,0
2777,8,2,2,6,0,3,9,33.3,6,13,1,12,6,14,20,0
2778,10,5,3,7,0,3,4,75,1,4,0,4,0,10,4,0
2779,12,7,9,2,1,8,10,80,2,6,3,3,3,15,17,0
2780,1,0,0,1,0,1,1,100,0,3,3,0,0,1,1,0
2781,7,4,4,3,0,4,7,57.1,3,13,11,2,16,23,99,0
2782,1,0,1,0,0,1,1,100,0,0,0,0,0,1,0,0
2783,27,14,20,7,0,19,27,70.4,8,17,13,4,16,43,72,0
2784,42,23,15,23,4,17,33,51.5,16,31,14,17,21,63,41,3
2785,0,0,0,0,0,0,0,,0,0,0,0,0,0,0,0
2786,6,3,1,4,1,1,9,11.1,8,6,2,4,4,10,6,0
2787,30,19,10,13,7,10,34,29.4,24,14,3,11,4,34,7,0
2788,2,1,1,0,1,1,1,100,0,5,3,2,0,2,16,0
2789,36,19,14,18,4,10,25,40,15,14,4,10,6,42,6,0